,title,studio,year,domestic_gross,foreign_gross,total_gross
0,Toy Story 3,BV,2010,415000000,652000000,1067000000
1,Alice in Wonderland (2010),BV,2010,334200000,691300000,1025500000
2,Harry Potter and the Deathly Hallows Part 1,WB,2010,296000000,664300000,960300000
3,Inception,WB,2010,292600000,535700000,828300000
4,Shrek Forever After,P/DW,2010,238700000,513900000,752600000
5,The Twilight Saga: Eclipse,Sum.,2010,300500000,398000000,698500000
6,Iron Man 2,Par.,2010,312400000,311500000,623900000
7,Tangled,BV,2010,200800000,391000000,591800000
8,Despicable Me,Uni.,2010,251500000,291600000,543100000
9,How to Train Your Dragon,P/DW,2010,217600000,277300000,494900000
10,Clash of the Titans (2010),WB,2010,163200000,330000000,493200000
11,The Chronicles of Narnia: The Voyage of the Dawn Treader,Fox,2010,104400000,311300000,415700000
12,The King's Speech,Wein.,2010,135500000,275400000,410900000
13,Tron Legacy,BV,2010,172100000,228000000,400100000
14,The Karate Kid,Sony,2010,176600000,182500000,359100000
15,Prince of Persia: The Sands of Time,BV,2010,90800000,245600000,336400000
16,Black Swan,FoxS,2010,107000000,222400000,329400000
17,Megamind,P/DW,2010,148400000,173500000,321900000
18,Robin Hood,Uni.,2010,105300000,216400000,321700000
19,The Last Airbender,Par.,2010,131800000,187900000,319700000
20,Little Fockers,Uni.,2010,148400000,162200000,310600000
21,Resident Evil: Afterlife,SGem,2010,60100000,240100000,300200000
22,Shutter Island,Par.,2010,128000000,166800000,294800000
23,Salt,Sony,2010,118300000,175200000,293500000
24,Sex and the City 2,WB (NL),2010,95300000,193000000,288300000
25,The Tourist,Sony,2010,67600000,210700000,278300000
26,The Expendables,LGF,2010,103100000,171400000,274500000
27,Grown Ups,Sony,2010,162000000,109400000,271400000
28,Knight & Day,Fox,2010,76400000,185500000,261900000
29,True Grit,Par.,2010,171200000,81000000,252200000
30,Gulliver's Travels,Fox,2010,42800000,194600000,237400000
31,Percy Jackson & The Olympians: The Lightning Thief,Fox,2010,88800000,137700000,226500000
32,The Social Network,Sony,2010,97000000,128000000,225000000
33,Valentine's Day,WB (NL),2010,110500000,106000000,216500000
34,The Sorcerer's Apprentice,BV,2010,63200000,152100000,215300000
35,Due Date,WB,2010,100500000,111200000,211700000
36,Eat Pray Love,Sony,2010,80600000,124000000,204600000
37,Yogi Bear,WB,2010,100200000,101300000,201500000
38,Red,Sum.,2010,90400000,108600000,199000000
39,Paranormal Activity 2,Par.,2010,84800000,92800000,177600000
40,The A-Team,Fox,2010,77200000,100000000,177200000
41,Jackass 3-D,Par.,2010,117200000,54500000,171700000
42,The Other Guys,Sony,2010,119200000,51200000,170400000
43,Unstoppable,Fox,2010,81600000,86200000,167800000
44,Step Up 3-D,BV,2010,42400000,116900000,159300000
45,The Book of Eli,WB,2010,94800000,62300000,157100000
46,The Town,WB,2010,92200000,61800000,154000000
47,Date Night,Fox,2010,98700000,53600000,152300000
48,Legend of the Guardians: The Owls of Ga'Hoole,WB,2010,55700000,84400000,140100000
49,The Wolfman,Uni.,2010,62000000,77800000,139800000
50,The Bounty Hunter,Sony,2010,67099999,69300000,136399999
51,Saw 3D,LGF,2010,45700000,90400000,136100000
52,Wall Street: Money Never Sleeps,Fox,2010,52500000,82300000,134800000
53,The Fighter,Par.,2010,93600000,35600000,129200000
54,Predators,Fox,2010,52000000,75200000,127200000
55,A Nightmare on Elm Street (2010),WB (NL),2010,63100000,52600000,115700000
56,Dear John,SGem,2010,80000000,35000000,115000000
57,Cats & Dogs: The Revenge of Kitty Galore,WB,2010,43600000,68900000,112500000
58,Tooth Fairy,Fox,2010,60000000,52400000,112400000
59,Life as We Know It,WB,2010,53400000,52300000,105700000
60,Hereafter,WB,2010,32700000,72500000,105200000
61,The Girl with the Dragon Tattoo,MBox,2010,10100000,94300000,104400000
62,Love and Other Drugs,Fox,2010,32400000,70500000,102900000
63,Aftershock (Tangshan Dadizhen),CL,2010,63000,100200000,100263000
64,Killers,LGF,2010,47100000,51100000,98200000
65,Kick-Ass,LGF,2010,48100000,48100000,96200000
66,Green Zone,Uni.,2010,35100000,59800000,94900000
67,Nanny McPhee Returns,Uni.,2010,29000000,64200000,93200000
68,Get Him to the Greek,Uni.,2010,61000000,30300000,91300000
69,Burlesque,SGem,2010,39400000,50100000,89500000
70,The Last Song,BV,2010,63000000,26100000,89100000
71,Dinner for Schmucks,P/DW,2010,73000000,13800000,86800000
72,Marmaduke,Fox,2010,33600000,50100000,83700000
73,Piranha 3D,W/Dim.,2010,25000000,58200000,83200000
74,Oceans,BV,2010,19400000,63200000,82600000
75,Edge of Darkness,WB,2010,43300000,37800000,81100000
76,Vampires Suck,Fox,2010,36700000,43900000,80600000
77,Letters to Juliet,Sum.,2010,53000000,26100000,79100000
78,The Back-Up Plan,CBS,2010,37500000,40000000,77500000
79,If You Are the One 2 (Fei Cheng Wu Rao II),CL,2010,427000,75600000,76027000
80,Diary of a Wimpy Kid,Fox,2010,64000000,11700000,75700000
81,Easy A,SGem,2010,58400000,16600000,75000000
82,Hubble 3D,WB,2010,52400000,21500000,73900000
83,Takers,SGem,2010,57700000,11300000,69000000
84,Tales from Earthsea,BV,2010,48500,68600000,68648500
85,Legion (2010),SGem,2010,40200000,27800000,68000000
86,The American,Focus,2010,35600000,32299999,67899999
87,The Last Exorcism,LGF,2010,41000000,26700000,67700000
88,The Next Three Days,LGF,2010,21100000,46300000,67400000
89,The Girl Who Played with Fire,MBox,2010,7600000,59500000,67100000
90,Skyline,Uni.,2010,21400000,45400000,66800000
91,Hot Tub Time Machine,MGM,2010,50300000,14300000,64600000
92,Devil,Uni.,2010,33600000,29100000,62700000
93,127 Hours,FoxS,2010,18300000,42400000,60700000
94,Tyler Perry's Why Did I Get Married Too?,LGF,2010,60100000,578000,60678000
95,Secretariat,BV,2010,59700000,537000,60237000
96,The Ghost Writer,Sum.,2010,15500000,44700000,60200000
97,Morning Glory,Par.,2010,31000000,29000000,60000000
98,Remember Me,Sum.,2010,19100000,37000000,56100000
99,Cop Out,WB,2010,44900000,10700000,55600000
100,The Crazies,Over.,2010,39100000,15700000,54800000
101,From Paris with Love,LGF,2010,24100000,28700000,52800000
102,Daybreakers,LGF,2010,30100000,21300000,51400000
103,Alpha and Omega,LGF,2010,25100000,25400000,50500000
104,The Switch,Mira.,2010,27800000,22100000,49900000
105,She's Out of My League,Par.,2010,32000000,17800000,49800000
106,Death at a Funeral (2010),SGem,2010,42700000,6300000,49000000
107,How Do You Know,Sony,2010,30200000,18500000,48700000
108,Charlie St. Cloud,Uni.,2010,31200000,17000000,48200000
109,Scott Pilgrim vs. the World,Uni.,2010,31500000,16100000,47600000
110,Heartbreaker,IFC,2010,504000,46900000,47404000
111,The Spy Next Door,LGF,2010,24300000,20900000,45200000
112,"The Good, the Bad, the Weird",IFC,2010,128000,44100000,44228000
113,Machete,Fox,2010,26600000,17500000,44100000
114,The Girl Who Kicked the Hornet's Nest,MBox,2010,5200000,38300000,43500000
115,The Man From Nowhere,CJ,2010,528000,42500000,43028000
116,When in Rome,BV,2010,32700000,10400000,43100000
117,My Name is Khan,FoxS,2010,4000000,38300000,42300000
118,Going the Distance,WB (NL),2010,17800000,24200000,42000000
119,The Concert,Wein.,2010,658000,40500000,41158000
120,Agora,NM,2010,619000,38400000,39019000
121,For Colored Girls,LGF,2010,37700000,17300,37717300
122,Brooklyn's Finest,Over.,2010,27200000,9300000,36500000
123,Furry Vengeance,Sum.,2010,17600000,18600000,36200000
124,Faster,CBS,2010,23200000,12400000,35600000
125,The Kids Are All Right,Focus,2010,20800000,13900000,34700000
126,You Will Meet a Tall Dark Stranger,SPC,2010,3200000,31000000,34200000
127,The Secret in Their Eyes,SPC,2010,6400000,27600000,34000000
128,Avatar: Special Edition,Fox,2010,10700000,22500000,33200000
129,Leap Year,Uni.,2010,25900000,6700000,32600000
130,You Again,BV,2010,25700000,6300000,32000000
131,Mesrine: Killer Instinct,MBox,2010,552000,30500000,31052000
132,The Losers,WB,2010,23600000,5800000,29400000
133,Case 39,ParV,2010,13300000,14900000,28200000
134,Ramona and Beezus,Fox,2010,26200000,1100000,27300000
135,Splice,WB,2010,17000000,9800000,26800000
136,Fair Game (2010),Sum.,2010,9500000,14600000,24100000
137,Let Me In,Over.,2010,12100000,12000000,24100000
138,Mao's Last Dancer,Gold.,2010,4800000,17500000,22300000
139,Just Wright,FoxS,2010,21500000,29900,21529900
140,Our Family Wedding,FoxS,2010,20300000,1200000,21500000
141,My Soul to Take,Uni.,2010,14700000,6200000,20900000
142,71 Into the Fire,JS,2010,177000,20800000,20977000
143,"I Love You, Phillip Morris",RAtt.,2010,2000000,18700000,20700000
144,Country Strong,SGem,2010,20200000,310000,20510000
145,Another Year,SPC,2010,3200000,16500000,19700000
146,Youth in Revolt,W/Dim.,2010,15300000,4400000,19700000
147,Buried,LGF,2010,1000000,18100000,19100000
148,[Rec] 2,Magn.,2010,27800,18500000,18527800
149,Repo Men,Uni.,2010,13800000,4600000,18400000
150,A Prophet (Un proph√®te),SPC,2010,2100000,15800000,17900000
151,Soul Kitchen,IFC,2010,277000,17600000,17877000
152,Mother (2010),Magn.,2010,552000,16600000,17152000
153,Micmacs,SPC,2010,1300000,15100000,16400000
154,The Nutcracker in 3D,Free,2010,195000,16000000,16195000
155,Sea Rex 3D: Journey to a Prehistoric World,3D,2010,6100000,9900000,16000000
156,I Hate Luv Storys,UTV,2010,848000,14900000,15748000
157,Extraordinary Measures,CBS,2010,12100000,3100000,15200000
158,Somewhere,Focus,2010,1800000,12200000,14000000
159,Winter's Bone,RAtt.,2010,6500000,7300000,13800000
160,The Last Station,SPC,2010,6600000,6900000,13500000
161,Raajneeti,UTV,2010,1500000,11100000,12600000
162,Made in Dagenham,SPC,2010,1100000,11300000,12400000
163,Blue Valentine,Wein.,2010,9700000,2600000,12300000
164,Tamara Drewe,SPC,2010,560000,11400000,11960000
165,Chloe,SPC,2010,3100000,8600000,11700000
166,Looking for Eric,IFC,2010,55800,11500000,11555800
167,The Warrior's Way,Rela.,2010,5700000,5400000,11100000
168,I Am Love,Magn.,2010,5000000,5900000,10900000
169,Jonah Hex,WB,2010,10500000,356000,10856000
170,Harry Brown,Gold.,2010,1800000,8500000,10300000
171,Cyrus,FoxS,2010,7500000,2500000,10000000
172,Conviction,FoxS,2010,6800000,2900000,9700000
173,Get Low,SPC,2010,9200000,518000,9718000
174,Babies,Focus,2010,7300000,2200000,9500000
175,Stone,Over.,2010,1800000,7700000,9500000
176,Peepli Live,UTV,2010,758000,8700000,9458000
177,Never Let Me Go,FoxS,2010,2400000,7000000,9400000
178,Mid-August Lunch,Zeit.,2010,675000,8700000,9375000
179,MacGruber,Uni.,2010,8500000,797000,9297000
180,City Island,Anch.,2010,6700000,1200000,7900000
181,Inside Job,SPC,2010,4300000,3600000,7900000
182,The Joneses,RAtt.,2010,1500000,5500000,7000000
183,Centurion,Magn.,2010,124000,6700000,6824000
184,Animal Kingdom,SPC,2010,1000000,5700000,6700000
185,Nowhere Boy,Wein.,2010,1500000,5100000,6600000
186,It's Kind of a Funny Story,Focus,2010,6400000,128000,6528000
187,"Waiting for ""Superman""",ParV,2010,6400000,9300,6409300
188,Greenberg,Focus,2010,4200000,1900000,6100000
189,Coco Chanel & Igor Stravinsky,SPC,2010,1600000,4099999,5699999
190,Vincere,IFC,2010,619000,5100000,5719000
191,The Illusionist (2010),SPC,2010,2200000,3400000,5600000
192,Exit Through the Gift Shop,PDA,2010,3300000,2000000,5300000
193,Mademoiselle Chambon,Lorb.,2010,532000,4700000,5232000
194,Solitary Man,Anch.,2010,4400000,818000,5218000
195,Rabbit Hole,LGF,2010,2200000,2900000,5100000
196,Vision,Zeit.,2010,435000,4600000,5035000
197,Mother and Child,SPC,2010,1100000,3900000,5000000
198,The Runaways,App.,2010,3600000,1100000,4700000
199,Four Lions,Drft.,2010,305000,4400000,4705000
200,Wild Grass,SPC,2010,404000,4200000,4604000
201,Please Give,SPC,2010,4000000,280000,4280000
202,Monsters,Magn.,2010,237000,4000000,4237000
203,Rare Exports: A Christmas Tale,Osci.,2010,236000,3800000,4036000
204,The Killer Inside Me,IFC,2010,217000,3800000,4017000
205,The Perfect Game,IW,2010,1000000,2800000,3800000
206,To Save a Life,Gold.,2010,3800000,45800,3845800
207,Inspector Bellamy,IFC,2010,108000,3600000,3708000
208,Catfish,Rog.,2010,3200000,242000,3442000
209,Wild Target,Free,2010,109000,3300000,3409000
210,Outside the Law (Hors-la-loi),,2010,96900,3300000,3396900
211,Frozen (2010),Anch.,2010,246000,2900000,3146000
212,Dabangg,Eros,2010,1300000,1700000,3000000
213,Kites,Relbig.,2010,1600000,1300000,2900000
214,Letters to God,Viv.,2010,2800000,60300,2860300
215,Twelve,Hann.,2010,184000,2400000,2584000
216,Tees Maar Khan,UTV,2010,1100000,1400000,2500000
217,Fish Tank,IFC,2010,375000,2000000,2375000
218,Housefull,Eros,2010,1200000,1200000,2400000
219,Golmaal 3,Eros,2010,1100000,935000,2035000
220,After.Life,Anch.,2010,109000,1900000,2009000
221,Cairo Time,IFC,2010,1600000,391000,1991000
222,Flipped,WB,2010,1800000,0,1800000
223,Guzaarish,UTV,2010,1000000,695000,1695000
224,Ondine,Magn.,2010,550000,1100000,1650000
225,Anjaana Anjaani,Eros,2010,855000,761000,1616000
226,John Rabe,Strand,2010,67500,1400000,1467500
227,Restrepo,NGE,2010,1300000,105000,1405000
228,Raavan,Relbig.,2010,709000,648000,1357000
229,The City of Your Final Destination,Scre.,2010,493000,859000,1352000
231,Ajami,Kino,2010,622000,669000,1291000
232,Army of Crime,Lorb.,2010,37000,1200000,1237000
233,Lebanon,SPC,2010,368000,830000,1198000
234,Howl,Osci.,2010,617000,566000,1183000
235,Videocracy,Kino,2010,23700,1200000,1223700
236,When You're Strange,Abr.,2010,246000,901000,1147000
237,The Salvation Poem (Poema de Salvacion),CZ,2010,915000,183000,1098000
238,Casino Jack,ATO,2010,1000000,40700,1040700
239,Leaving,IFC,2010,176000,893000,1069000
240,Khatta Meetha,Eros,2010,542000,499000,1041000
241,We Are Family,UTV,2010,638000,393000,1031000
242,Leaves of Grass,First,2010,70100,949000,1019100
243,North Face,MBox,2010,711000,216000,927000
244,Creation,NM,2010,341000,555000,896000
245,No One Knows About Persian Cats,IFC,2010,81800,798000,879800
246,Carlos,IFC,2010,146000,726000,872000
247,Hideaway (Le Refuge),Strand,2010,34500,837000,871500
248,The Disappearance of Alice Creed,Anch.,2010,167000,701000,868000
249,Break Ke Baad,Relbig.,2010,428000,389000,817000
250,Veer (2010),Eros,2010,527000,277000,804000
251,Life During Wartime,IFC,2010,281000,487000,768000
252,Enter the Void,IFC,2010,336000,418000,754000
253,The Secret of Kells,GK,2010,677000,62700,739700
254,The Polar Express (IMAX re-issue 2010),WB,2010,673000,0,673000
255,No Problem,Eros,2010,285000,369000,654000
256,All Good Things,Magn.,2010,582000,62500,644500
257,Jack Goes Boating,Over.,2010,542000,77600,619600
258,Holy Rollers,FInd.,2010,303000,305000,608000
259,Chain Letter,NFC,2010,139000,447000,586000
260,I Spit on Your Grave,Anch.,2010,93100,480000,573100
261,I'm Still Here,Magn.,2010,409000,160000,569000
262,Salt of this Sea,Lorb.,2010,11700,545000,556700
263,Undertow (2010),TFC,2010,109000,393000,502000
264,Father of My Children,IFC,2010,144000,335000,479000
265,The Greatest (2010),Pala.,2010,115000,359000,474000
266,The Extra Man,Magn.,2010,453000,4500,457500
267,Tiny Furniture,IFC,2010,392000,0,392000
268,Dogtooth,Kino,2010,110000,274000,384000
269,Grease (Sing-a-Long re-issue),Par.,2010,366000,0,366000
270,The Tempest,Mira.,2010,278000,68700,346700
271,The Good Heart,Magn.,2010,20900,323000,343900
272,Formosa Betrayed,Scre.,2010,225000,101000,326000
273,Red Hill,Strand,2010,21100,300000,321100
274,Welcome to the Rileys,Gold.,2010,159000,158000,317000
275,"A Woman, A Gun and A Noodle Shop",SPC,2010,191000,121000,312000
276,The Girl on the Train,Strand,2010,208000,97100,305100
277,Mesrine: Public Enemy No. 1,MBox,2010,275000,28100,303100
278,44 Inch Chest,Imag.,2010,39000,255000,294000
279,Karthik Calling Karthik,Eros,2010,286000,7100,293100
280,Last Train Home,Zeit.,2010,288000,0,288000
281,Eyes Wide Open,NAV,2010,26300,250000,276300
282,Waste Land,Arth.,2010,188000,88700,276700
283,South of the Border,CLS,2010,199000,70800,269800
284,Human Centipede,IFC,2010,181000,70700,251700
285,"Lovely, Still",Mont.,2010,128000,106000,234000
286,The Girl (Flickan),Olive,2010,2200,229000,231200
287,Sweetgrass,CGld,2010,207000,0,207000
288,Bitch Slap,Free,2010,17400,182000,199400
289,Chance Pe Dance,UTV,2010,169000,24300,193300
290,Client 9: The Rise and Fall of Eliot Spitzer,Magn.,2010,189000,3500,192500
291,Casino Jack and the United States of Money,Magn.,2010,177000,0,177000
292,Perrier's Bounty,IFC,2010,800,167000,167800
293,Around a Small Mountain,CGld,2010,33200,131000,164200
294,Spring Fever,Strand,2010,10800,150000,160800
295,The Eclipse,Magn.,2010,133000,26400,159400
296,George A. Romero's Survival of the Dead,Magn.,2010,102000,41500,143500
297,The Romantics,FOAK,2010,107000,17300,124300
299,Freakonomics,Magn.,2010,101000,16400,117400
300,Saint John of Las Vegas,IVP,2010,103000,9100,112100
301,Band Baaja Baaraat,Yash,2010,43800,60700,104500
303,Kisses,Osci.,2010,81700,15300,97000
304,Waking Sleeping Beauty,BV,2010,80700,4200,84900
305,Enemies of the People,ICir,2010,73200,6400,79600
307,Hadewijch,IFC,2010,5000,57500,62500
308,Alamar,FM,2010,61600,0,61600
309,As Good as Dead,First,2010,2000,53600,55600
310,Inhale,IFC,2010,4100,51000,55100
311,Hatchet 2,Vita.,2010,52600,0,52600
312,District B13: Ultimatum,Magn.,2010,36100,16200,52300
313,GasLand,WOW,2010,30800,18600,49400
314,Boogie Woogie,IFC,2010,2600,44900,47500
315,Come Undone (2010),FM,2010,10000,31300,41300
316,The Red Baron,Mont.,2010,37200,3100,40300
317,Bluebeard,Strand,2010,33500,5200,38700
318,Daddy Longlegs,IFC,2010,21800,11500,33300
319,Living in Emergency,Truly,2010,32200,0,32200
320,Nenette,Kino,2010,18000,5400,23400
321,Picture Me,Strand,2010,12000,10400,22400
322,The Thorn in the Heart,Osci.,2010,7400,10500,17900
323,The Taqwacores,Strand,2010,11400,0,11400
324,Cherry,Abr.,2010,11400,0,11400
325,Terkel in Trouble,Indic.,2010,10800,0,10800
326,Kimjongilia,Lorb.,2010,4400,0,4400
328,Harry Potter and the Deathly Hallows Part 2,WB,2011,381000000,960500000,1341500000
329,Transformers: Dark of the Moon,P/DW,2011,352400000,771400000,1123800000
330,Pirates of the Caribbean: On Stranger Tides,BV,2011,241100000,804600000,1045700000
331,The Twilight Saga: Breaking Dawn Part 1,Sum.,2011,281300000,430900000,712200000
332,Mission: Impossible - Ghost Protocol,Par.,2011,209400000,485300000,694700000
333,Kung Fu Panda 2,P/DW,2011,165200000,500400000,665600000
334,Fast Five,Uni.,2011,209800000,416300000,626100000
335,The Hangover Part II,WB,2011,254500000,332300000,586800000
336,The Smurfs,Sony,2011,142600000,421100000,563700000
337,Cars 2,BV,2011,191500000,370700000,562200000
338,Puss in Boots,P/DW,2011,149300000,405700000,555000000
339,Sherlock Holmes: A Game of Shadows,WB,2011,186800000,358600000,545400000
340,Rio,Fox,2011,143600000,341000000,484600000
341,Rise of the Planet of the Apes,Fox,2011,176800000,305000000,481800000
342,Thor,Par.,2011,181000000,268300000,449300000
343,The Adventures of Tintin,Par.,2011,77600000,296400000,374000000
344,Captain America: The First Avenger,Par.,2011,176700000,193900000,370600000
345,X-Men: First Class,Fox,2011,146400000,207200000,353600000
346,Alvin and the Chipmunks: Chipwrecked,Fox,2011,133100000,209600000,342700000
347,Real Steel,BV,2011,85500000,213800000,299300000
348,Bridesmaids,Uni.,2011,169100000,119300000,288400000
349,Super 8,Par.,2011,127000000,133100000,260100000
350,Rango,Par.,2011,123500000,122200000,245700000
351,The Girl with the Dragon Tattoo (2011),Sony,2011,102500000,130100000,232600000
352,The Green Hornet,Sony,2011,98800000,129000000,227800000
353,Immortals,Rela.,2011,83500000,143400000,226900000
354,Green Lantern,WB,2011,116600000,103300000,219900000
355,The Help,BV,2011,169700000,46900000,216600000
356,Bad Teacher,Sony,2011,100300000,115900000,216200000
357,Just Go With It,Sony,2011,103000000,111900000,214900000
358,Battle: Los Angeles,Sony,2011,83600000,128300000,211900000
359,Horrible Bosses,WB (NL),2011,117500000,92100000,209600000
360,Paranormal Activity 3,Par.,2011,104000000,103000000,207000000
361,Gnomeo and Juliet,BV,2011,100000000,94000000,194000000
362,Mr. Popper's Penguins,Fox,2011,68200000,119100000,187300000
363,Hugo,Par.,2011,73900000,111900000,185800000
364,The Lion King (in 3D),BV,2011,94200000,91300000,185500000
365,Hop,Uni.,2011,108100000,75900000,184000000
366,War Horse,BV,2011,79900000,97700000,177600000
367,The Descendants,FoxS,2011,82600000,94700000,177300000
368,Cowboys & Aliens,Uni.,2011,100200000,74600000,174800000
369,In Time,Fox,2011,37500000,136400000,173900000
370,Zookeeper,Sony,2011,80400000,89500000,169900000
371,The Muppets,BV,2011,88600000,76600000,165200000
372,Limitless,Rela.,2011,79200000,82600000,161800000
373,Johnny English Reborn,Uni.,2011,8300000,151800000,160100000
374,Final Destination 5,WB (NL),2011,42600000,115300000,157900000
375,Tower Heist,Uni.,2011,78000000,74900000,152900000
376,Midnight in Paris,SPC,2011,56800000,94300000,151100000
377,Happy Feet Two,WB,2011,64000000,86400000,150400000
378,I Am Number Four,BV,2011,55100000,94800000,149900000
379,Jack and Jill,Sony,2011,74200000,75500000,149700000
380,Friends with Benefits,SGem,2011,55800000,93700000,149500000
381,No Strings Attached,Par.,2011,70700000,78600000,149300000
382,Arthur Christmas,Sony,2011,46500000,101000000,147500000
383,Source Code,Sum.,2011,54700000,92600000,147300000
384,"Crazy, Stupid, Love.",WB,2011,84400000,58500000,142900000
385,New Year's Eve,WB (NL),2011,54500000,87500000,142000000
386,Contagion,WB,2011,75700000,59800000,135500000
387,The Artist,Wein.,2011,44700000,88800000,133500000
388,The Three Musketeers (2011),Sum.,2011,20400000,111900000,132300000
389,Unknown,WB,2011,63700000,67099999,130799999
390,The Adjustment Bureau,Uni.,2011,62500000,65400000,127900000
391,We Bought a Zoo,Fox,2011,75600000,44500000,120100000
392,Water for Elephants,Fox,2011,58700000,58400000,117100000
393,The Iron Lady,Wein.,2011,30000000,84900000,114900000
394,Moneyball,Sony,2011,75600000,34600000,110200000
395,Sanctum,Uni.,2011,23200000,85400000,108600000
396,Justin Bieber: Never Say Never,Par.,2011,73000000,26000000,99000000
397,Paul,Uni.,2011,37400000,60600000,98000000
398,Scream 4,W/Dim.,2011,38200000,59000000,97200000
399,Insidious,FD,2011,54000000,43000000,97000000
400,The Rite,WB (NL),2011,33000000,63000000,96000000
401,Dolphin Tale,WB,2011,72300000,23100000,95400000
402,Season of the Witch,Rela.,2011,24800000,66800000,91600000
403,Sucker Punch,WB,2011,36400000,53400000,89800000
404,Red Riding Hood,WB,2011,37700000,51500000,89200000
405,Spy Kids: All the Time in the World,W/Dim.,2011,38500000,47000000,85500000
406,J. Edgar,WB,2011,37300000,47600000,84900000
407,Hall Pass,WB (NL),2011,45100000,38100000,83200000
408,"Big Mommas: Like Father, Like Son",Fox,2011,37900000,44800000,82700000
409,Abduction,LGF,2011,28100000,54000000,82100000
410,"Tinker, Tailor, Soldier, Spy",Focus,2011,24100000,56500000,80600000
411,Priest,SGem,2011,29100000,49200000,78300000
412,Drive (2011),FD,2011,35100000,41100000,76200000
413,The Mechanic,CBS,2011,29100000,47000000,76100000
414,The Ides of March,Sony,2011,41000000,35000000,76000000
415,The Change-Up,Uni.,2011,37100000,38400000,75500000
416,The Lincoln Lawyer,LGF,2011,58000000,17000000,75000000
417,Diary of a Wimpy Kid: Rodrick Rules,Fox,2011,52700000,19700000,72400000
418,Larry Crowne,Uni.,2011,35600000,36400000,72000000
419,The Dilemma,Uni.,2011,48500000,21200000,69700000
420,The Darkest Hour,Sum.,2011,21400000,43200000,64600000
421,Hanna,Focus,2011,40300000,23500000,63800000
422,Footloose (2011),Par.,2011,51800000,11700000,63500000
423,Elite Squad: The Enemy Within,Vari.,2011,100000,62900000,63000000
424,Colombiana,TriS,2011,36700000,24300000,61000000
425,Something Borrowed,WB,2011,39000000,21100000,60100000
426,One Day,Focus,2011,13800000,45500000,59300000
427,Beginning of the Great Revival,CL,2011,151000,58200000,58351000
428,Killer Elite,ORF,2011,25100000,31300000,56400000
429,Extremely Loud & Incredibly Close,WB,2011,31800000,23400000,55200000
430,The Tree of Life,FoxS,2011,13300000,41000000,54300000
431,Tyler Perry's Madea's Big Happy Family,LGF,2011,53300000,816000,54116000
432,Detective Dee and the Mystery of the Phantom Flame,IM,2011,460000,51300000,51760000
433,Winnie the Pooh,BV,2011,26700000,23200000,49900000
434,Conan the Barbarian (2011),LGF,2011,21300000,27500000,48800000
435,Soul Surfer,TriS,2011,43900000,3200000,47100000
436,War of the Arrows,CJ,2011,251000,45800000,46051000
437,Arthur (2011),WB,2011,33000000,12700000,45700000
438,The Debt,Focus,2011,31200000,14500000,45700000
439,Beastly,CBS,2011,27900000,15300000,43200000
440,Of Gods and Men,SPC,2011,4000000,38200000,42200000
441,Born to Be Wild (IMAX),WB,2011,25900000,15600000,41500000
442,Evangelion 2.0: You Can (Not) Advance,Elev.,2011,134000,41000000,41134000
443,Fright Night (2011),BV,2011,18300000,22700000,41000000
444,30 Minutes or Less,Sony,2011,37100000,3500000,40600000
445,The Roommate,SGem,2011,37300000,3200000,40500000
446,Shark Night 3D,Rela.,2011,18900000,21300000,40200000
447,Monte Carlo,Fox,2011,23200000,16500000,39700000
448,50/50,Sum.,2011,35000000,4200000,39200000
449,Mars Needs Moms,BV,2011,21400000,17600000,39000000
450,Dream House,Uni.,2011,21300000,17200000,38500000
451,Jumping the Broom,TriS,2011,37300000,415000,37715000
452,Don't Be Afraid of the Dark,FD,2011,24000000,12900000,36900000
453,RA One,Eros,2011,2500000,33400000,35900000
454,A Very Harold & Kumar 3D Christmas,WB,2011,35100000,326000,35426000
455,My Week with Marilyn,Wein.,2011,14600000,20500000,35100000
456,The Sitter,Fox,2011,30400000,4500000,34900000
457,Jane Eyre,Focus,2011,11200000,23500000,34700000
458,Courageous,TriS,2011,34500000,0,34500000
459,Shaolin,Vari.,2011,66100,33600000,33666100
460,African Cats,BV,2011,15400000,15400000,30800000
461,The Skin I Live In,SPC,2011,3200000,27700000,30900000
462,I Don't Know How She Does It,Wein.,2011,9700000,20900000,30600000
463,What's Your Number?,Fox,2011,14000000,16399999,30399999
464,Drive Angry,Sum.,2011,10700000,18200000,28900000
465,Carnage (2011),SPC,2011,2500000,25100000,27600000
466,A Dangerous Method,SPC,2011,5700000,21800000,27500000
467,The Thing (2011),Uni.,2011,16900000,10500000,27400000
468,The Eagle,Focus,2011,19500000,7600000,27100000
469,Legend of the Fist: The Return of Chen Zhen,Vari.,2011,50400,26500000,26550400
470,Apollo 18,W/Dim.,2011,17700000,7900000,25600000
471,Biutiful,RAtt.,2011,5100000,20000000,25100000
472,Your Highness,Uni.,2011,21600000,3300000,24900000
473,Our Idiot Brother,Wein.,2011,24800000,0,24800000
474,The Rum Diary,FD,2011,13100000,10800000,23900000
475,The Women on the 6th Floor,Strand,2011,720000,22500000,23220000
476,Potiche,MBox,2011,1600000,21600000,23200000
477,Warrior,LGF,2011,13700000,9400000,23100000
478,Young Adult,Par.,2011,16300000,6600000,22900000
479,Sarah's Key,Wein.,2011,7700000,13400000,21100000
480,The Way Back,NM,2011,2700000,17600000,20300000
481,A Separation,SPC,2011,7100000,12800000,19900000
482,The Guard,SPC,2011,5400000,14200000,19600000
483,Margin Call,RAtt.,2011,5400000,14200000,19600000
484,Glee The 3D Concert Movie,Fox,2011,11900000,6800000,18700000
485,Shame,FoxS,2011,3900000,13800000,17700000
486,13 Assassins,Magn.,2011,803000,16800000,17603000
487,Hoodwinked Too! Hood vs. Evil,Wein.,2011,10100000,6800000,16900000
488,The Heir Apparent: Largo Winch,MBox,2011,10400,16900000,16910400
489,The Last Godfather,RAtt.,2011,164000,16600000,16764000
490,Delhi Belly,UTV,2011,1500000,15200000,16700000
491,Melancholia,Magn.,2011,3000000,12900000,15900000
492,Judy Moody and the NOT Bummer Summer,Rela.,2011,15000000,678000,15678000
493,The Conspirator,RAtt.,2011,11500000,3900000,15400000
494,Anonymous,Sony,2011,4500000,10900000,15400000
495,Ip Man 2: Legend of the Grandmaster,Vari.,2011,206000,14900000,15106000
496,The Housemaid,IFC,2011,158000,14600000,14758000
497,Desert Flower,NGE,2011,44300,14600000,14644300
498,Pina,IFC,2011,3500000,11100000,14600000
499,Beginners,Focus,2011,5800000,8500000,14300000
500,My Afternoons with Margueritte,Cohen,2011,667000,13600000,14267000
501,I Saw the Devil,Magn.,2011,129000,12600000,12729000
502,The Hedgehog,NeoC,2011,708000,12000000,12708000
503,Gainsbourg: A Heroic Life,MBox,2011,233000,12000000,12233000
504,The Warring States,CL,2011,69000,11800000,11869000
505,What Women Want (Wo Zhi Nu Run Xin),CL,2011,124000,11700000,11824000
506,Snow Flower and the Secret Fan,FoxS,2011,1300000,10000000,11300000
507,Win Win,FoxS,2011,10200000,652000,10852000
508,Flying Monsters,NGE,2011,5700000,5100000,10800000
509,City of Life and Death,Kino,2011,123000,10600000,10723000
510,Le Havre,Jan.,2011,612000,9900000,10512000
511,Straw Dogs (2011),SGem,2011,10300000,0,10300000
512,Prom,BV,2011,10100000,0,10100000
513,In a Better World,SPC,2011,1000000,8600000,9600000
514,Trespass (2011),MNE,2011,24100,9600000,9624100
515,Saving Private Perez,LGF,2011,1400000,7900000,9300000
516,Point Blank,Magn.,2011,708000,8500000,9208000
517,Winter in Wartime,SPC,2011,543000,8700000,9243000
518,Barney's Version (U.S. only),SPC,2011,4400000,4000000,8400000
519,Outrage (2011),Magn.,2011,44700,8400000,8444700
520,Senna,PDA,2011,1600000,6600000,8200000
521,Last Night,Trib.,2011,99000,7600000,7699000
522,The Big Year,Fox,2011,7200000,244000,7444000
523,The Beaver,Sum.,2011,971000,6300000,7271000
524,Take Me Home Tonight,Rela.,2011,6900000,0,6900000
525,Cedar Rapids,FoxS,2011,6900000,0,6900000
526,The Princess of Montpensier,IFC,2011,352000,6400000,6752000
527,Cave of Forgotten Dreams,IFC,2011,5300000,1200000,6500000
528,Sex and Zen 3D: Extreme Ecstasy,CL,2011,153000,6200000,6353000
529,We Need to Talk About Kevin,Osci.,2011,1700000,4300000,6000000
530,Attack the Block,SGem,2011,1000000,4800000,5800000
531,Even the Rain,Vita.,2011,518000,5300000,5818000
532,Young Goethe in Love,MBox,2011,162000,5600000,5762000
533,11-11-11,Rocket,2011,32800,5700000,5732800
534,Certified Copy,IFC,2011,1400000,4099999,5499999
535,Thank You (2011),UTV,2011,464000,5000000,5464000
536,The Company Men,Wein.,2011,4400000,441000,4841000
538,Tucker & Dale Vs. Evil,Magn.,2011,224000,4500000,4724000
539,London Boulevard,IFC,2011,16100,4600000,4616100
540,Dylan Dog: Dead of Night,OMNI/FSR,2011,1200000,3400000,4600000
541,The Names of Love,MBox,2011,514000,4099999,4613999
542,The Way,PDA,2011,4400000,0,4400000
543,Burke and Hare,IFC,2011,4800,4300000,4304800
544,King of Devil's Island,FM,2011,7600,4200000,4207600
545,Bride Flight,MBox,2011,501000,3700000,4201000
546,Trollhunter,Magn.,2011,253000,3900000,4153000
547,Buck,IFC,2011,4000000,0,4000000
548,Carancho,Strand,2011,85500,3900000,3985500
549,Like Crazy,ParV,2011,3400000,336000,3736000
550,The Double,Imag.,2011,138000,3600000,3738000
551,Don 2,Relbig.,2011,3700000,0,3700000
552,Love Crime,IFC,2011,540000,3100000,3640000
553,Incendies (U.S. only),SPC,2011,2100000,1500000,3600000
554,Martha Marcy May Marlene,FoxS,2011,3000000,548000,3548000
555,Fireflies in the Garden,,2011,70600,3300000,3370600
556,The King's Speech (PG-13),Wein.,2011,3300000,0,3300000
557,Machine Gun Preacher,Rela.,2011,539000,2800000,3339000
558,The Last Circus,Magn.,2011,40500,3200000,3240500
559,From Prada to Nada,LGF,2011,3000000,123000,3123000
560,Flypaper,IFC,2011,5000,3100000,3105000
561,Zindagi Na Milegi Dobara,Eros,2011,3100000,0,3100000
562,Take Shelter,SPC,2011,1700000,1400000,3100000
563,The Greatest Miracle,KKM,2011,555000,2500000,3055000
564,Rapt,Lorb.,2011,45800,2900000,2945800
565,Pastorela,LGF,2011,161000,2700000,2861000
566,The Double Hour,Gold.,2011,1500000,1200000,2700000
567,Everything Must Go,RAtt.,2011,2700000,0,2700000
568,3 (2011),Strand,2011,60000,2600000,2660000
569,Oranges and Sunshine,Cohen,2011,143000,2400000,2543000
570,Ong Bak 3,Magn.,2011,14900,2300000,2314900
571,Poetry,Kino,2011,356000,1900000,2256000
572,The Tree,Zeit.,2011,71200,2100000,2171200
573,"The Butcher, the Chef and the Swordsman",CL,2011,47900,2000000,2047900
574,The Trip (2011),IFC,2011,2000000,0,2000000
575,Armadillo,Lorb.,2011,14600,2000000,2014600
576,Bodyguard,Relbig.,2011,1800000,0,1800000
577,Brighton Rock,IFC,2011,230000,1600000,1830000
578,A Somewhat Gentle Man,Strand,2011,37700,1800000,1837700
579,The Topp Twins: Untouchable Girls,Argo.,2011,29300,1800000,1829300
580,Another Earth,FoxS,2011,1300000,456000,1756000
581,A Better Life,Sum.,2011,1800000,0,1800000
582,Chalet Girl,IFC,2011,1700,1700000,1701700
583,Yamla Pagla Deewana,Eros,2011,993000,600000,1593000
584,Bill Cunningham New York,Zeit.,2011,1500000,0,1500000
585,The Art of Getting By,FoxS,2011,1400000,0,1400000
586,The Devil's Double,LGF,2011,1400000,0,1400000
587,Uncle Boonmee Who Can Recall His Past Lives,Strand,2011,184000,946000,1130000
588,The Whistleblower,Gold.,2011,1100000,0,1100000
589,Red State,SMod,2011,1100000,0,1100000
590,London River,Libre,2011,7200,1100000,1107200
591,Desi Boyz,Eros,2011,1100000,0,1100000
592,When We Leave (Die Fremde),Olive,2011,19600,1100000,1119600
593,There Be Dragons,Gold.,2011,1100000,0,1100000
594,Vanishing on 7th Street,Magn.,2011,22700,1000000,1022700
595,Page One: A Year Inside the New York Times,Magn.,2011,1100000,0,1100000
596,The Time That Remains,IFC,2011,32900,1000000,1032900
597,Rockstar (2011),Eros,2011,987000,0,987000
598,Meek's Cutoff,Osci.,2011,978000,0,978000
599,Texas Killing Fields,Anch.,2011,45500,912000,957500
600,Ready,Eros,2011,955000,0,955000
601,Miral,Wein.,2011,373000,527000,900000
602,Submarine,Wein.,2011,468000,397000,865000
603,Higher Ground,SPC,2011,842000,0,842000
604,Mozart's Sister,MBox,2011,708000,132000,840000
605,Plastic Planet,FRun,2011,3200,836000,839200
606,Chillar Party,UTV,2011,6300,826000,832300
607,Mausam,Eros,2011,728000,0,728000
608,The First Grader,NGE,2011,332000,382000,714000
609,Hobo With a Shotgun,Magn.,2011,703000,0,703000
610,Tabloid,IFC,2011,697000,0,697000
611,Dhobi Ghat (Mumbai Diaries),UTV,2011,577000,102000,679000
612,Aarakshan (Reservation),Relbig.,2011,651000,0,651000
613,POM Wonderful Presents: The Greatest Movie Ever Sold,SPC,2011,638000,0,638000
614,No One Killed Jessica,UTV,2011,441000,193000,634000
615,Korkoro,Lorb.,2011,8200,619000,627200
616,Blackthorn,Magn.,2011,201000,423000,624000
617,How I Ended This Summer,FM,2011,8700,614000,622700
618,The Ledge,IFC,2011,9200,602000,611200
619,Heartbeats,IFC,2011,68700,520000,588700
620,The Future,RAtt.,2011,569000,0,569000
621,Dum Maaro Dum,FoxS,2011,564000,0,564000
622,Double Dhamaal,Relbig.,2011,544000,0,544000
623,Kaboom,IFC,2011,119000,421000,540000
624,Mere Brother Ki Dulhan,Yash,2011,496000,0,496000
625,Weekend (2011),IFC,2011,485000,0,485000
626,Protektor,FM,2011,3000,469000,472000
627,Circumstance,RAtt.,2011,454000,0,454000
628,The Other Woman,IFC,2011,25400,427000,452400
629,Project Nim,RAtt.,2011,411000,0,411000
630,Rage (Rabia),Strand,2011,5600,403000,408600
631,The Human Resources Manager,FM,2011,64000,329000,393000
632,Hesher,WHE,2011,383000,0,383000
633,7 Khoon Maaf,UTV,2011,270000,94700,364700
634,Another Happy Day,P4,2011,8500,347000,355500
635,Singham,Relbig.,2011,351000,0,351000
636,The Mill and the Cross,KC,2011,312000,30300,342300
637,Super,IFC,2011,328000,0,328000
638,L'Amour Fou,IFC,2011,312000,0,312000
639,Being Elmo: A Puppeteer's Journey,SD,2011,304000,0,304000
640,In the Land of Blood and Honey,FD,2011,304000,0,304000
641,Special Treatment,FRun,2011,8900,286000,294900
642,Illegal (2011),FM,2011,700,289000,289700
643,The Interrupters,CGld,2011,282000,0,282000
644,Rascals,Eros,2011,274000,0,274000
645,The Black Power Mix Tape: 1967-1975,IFC,2011,274000,0,274000
646,Black Death,Magn.,2011,22600,243000,265600
647,Le Quattro Volte,Lorb.,2011,153000,103000,256000
648,Life in a Day,NGE,2011,253000,0,253000
649,Caterpillar,Lorb.,2011,4200,248000,252200
650,Little Girl (La Pivellina),FRun,2011,1400,236000,237400
651,El Bulli: Cooking in Progress,AM,2011,237000,0,237000
652,"If I Want to Whistle, I Whistle",FM,2011,12100,220000,232100
653,Into the Abyss,IFC,2011,224000,0,224000
654,HappyThankYouMorePlease,Anch.,2011,216000,0,216000
655,The Robber,Kino,2011,83500,125000,208500
656,Henry's Crime,MPFT,2011,103000,102000,205000
657,A Good Old Fashioned Orgy,Gold.,2011,200000,0,200000
658,Film Socialisme,Lorb.,2011,33000,159000,192000
659,Bol,Eros,2011,189000,0,189000
660,Leap Year (2011),Strand,2011,13000,175000,188000
661,A Screaming Man,FM,2011,9900,175000,184900
662,Jig,Scre.,2011,184000,0,184000
663,Nostalgia for the Light,Icar.,2011,164000,13700,177700
664,Anchor Baby,AGF,2011,15800,161000,176800
665,Bellflower,Osci.,2011,168000,0,168000
666,Restless (2011),SPC,2011,163000,0,163000
667,Road to Nowhere,Mont.,2011,40300,121000,161300
668,Magic Trip,Magn.,2011,155000,0,155000
669,Eames: The Architect and the Painter,FRun,2011,153000,0,153000
670,Revenge of the Electric Car,A23,2011,151000,0,151000
671,The Human Centipede 2: Full Sequence,IFC,2011,142000,0,142000
672,Cold Weather,IFC,2011,141000,0,141000
673,Game (2011),Eros,2011,140000,0,140000
674,1911,Vari.,2011,136000,0,136000
675,"Life, Above All",SPC,2011,134000,0,134000
676,Tomboy (2011),Da.,2011,130000,0,130000
677,Octubre,NYer,2011,32100,96700,128800
678,The Arbor,Strand,2011,21600,105000,126600
679,Mysteries of Lisbon,MBox,2011,111000,14900,125900
680,Vidal Sassoon: The Movie,P4,2011,86000,38600,124600
681,Trust (2011),MNE,2011,120000,0,120000
682,Steve Jobs: The Lost Interview,Magn.,2011,106000,0,106000
683,Rubber,Magn.,2011,100000,0,100000
684,The Man Who Fell to Earth (35th anniversary re-issue),Rialto,2011,100000,0,100000
685,Chalo Dilli,Eros,2011,94300,0,94300
686,The Whale,Pala.,2011,81900,0,81900
687,Beautiful Boy,Anch.,2011,77200,0,77200
688,Puncture,MNE,2011,68900,0,68900
689,A Beautiful Life,CL,2011,66200,0,66200
690,"Tuesday, After Christmas",Lorb.,2011,27800,36200,64000
691,Viva Riva!,MBox,2011,61800,0,61800
692,Murder 2,Eros,2011,59500,0,59500
693,Dirty Girl,Wein.,2011,55100,0,55100
694,Battleship Potemkin (2011 re-issue),Kino,2011,51200,0,51200
695,Love U Mr. Kalakaar,Eros,2011,48600,0,48600
696,Margaret,FoxS,2011,46500,0,46500
697,"Happy, Happy",Magn.,2011,45200,0,45200
698,The Myth of the American Sleepover,IFC,2011,41000,0,41000
699,Hell and Back Again,DF,2011,40600,0,40600
700,Khodorkovsky,KL,2011,39500,0,39500
701,Sleeping Beauty (2011) (II),IFC,2011,36600,0,36600
702,My Kingdom (2011),CL,2011,36500,0,36500
703,Love in Space,CL,2011,34800,0,34800
704,Stake Land,IFC,2011,33200,0,33200
705,Brotherhood (2011),P4,2011,19700,12700,32400
706,The Son of No One,Anch.,2011,30700,0,30700
707,Muran,UTV,2011,30100,0,30100
708,The Sleeping Beauty,Strand,2011,29100,0,29100
709,Tyrannosaur,Strand,2011,22300,0,22300
710,Ceremony,Magn.,2011,22300,0,22300
711,I'm Glad My Mother is Alive,Strand,2011,8700,13200,21900
712,Always Kabhi Kabhi,Eros,2011,21400,0,21400
714,5 Days of War,Anch.,2011,17500,0,17500
715,Aurora,CGld,2011,5700,5100,10800
716,Magic to Win,CL,2011,10700,0,10700
717,Wrecked,IFC,2011,8000,0,8000
718,My Piece of the Pie,IFC,2011,6900,0,6900
719,I Melt With You,Magn.,2011,6400,0,6400
720,My Joy,KL,2011,6300,0,6300
721,To Die Like a Man,Strand,2011,4000,900,4900
722,Blood Ties,ALP,2011,2800,0,2800
723,Knuckle,Vita.,2011,2600,0,2600
724,Main Street,Magn.,2011,2600,0,2600
725,"Love, Wedding, Marriage",IFC,2011,1900,0,1900
726,An Invisible Sign,IFC,2011,1300,0,1300
727,Marvel's The Avengers,BV,2012,623400000,895500000,1518900000
728,Skyfall,Sony,2012,304400000,804200000,1108600000
729,The Dark Knight Rises,WB,2012,448100000,636800000,1084900000
730,The Hobbit: An Unexpected Journey,WB (NL),2012,303000000,718100000,1021100000
731,Ice Age: Continental Drift,Fox,2012,161300000,715900000,877200000
732,The Twilight Saga: Breaking Dawn Part 2,LG/S,2012,292300000,537400000,829700000
733,The Amazing Spider-Man,Sony,2012,262000000,495900000,757900000
734,Madagascar 3: Europe's Most Wanted,P/DW,2012,216400000,530500000,746900000
735,The Hunger Games,LGF,2012,408000000,286400000,694400000
736,MIB 3,Sony,2012,179000000,445000000,624000000
737,Life of Pi,Fox,2012,125000000,484000000,609000000
738,Ted,Uni.,2012,218800000,330600000,549400000
739,Brave,BV,2012,237300000,303200000,540500000
740,Wreck-It Ralph,BV,2012,189400000,281800000,471200000
741,Les Miserables (2012),Uni.,2012,148800000,293000000,441800000
742,The Intouchables (U.S.-only),Wein.,2012,10200000,416400000,426600000
743,Django Unchained,Wein.,2012,162800000,262600000,425400000
744,Prometheus,Fox,2012,126500000,276900000,403400000
745,Snow White and the Huntsman,Uni.,2012,155300000,241300000,396600000
746,Taken 2,Fox,2012,139900000,236300000,376200000
747,Hotel Transylvania,Sony,2012,148300000,210100000,358400000
748,Dr. Seuss' The Lorax,Uni.,2012,214000000,134800000,348800000
749,Titanic 3D,Par.,2012,57900000,285700000,343600000
750,Journey 2: The Mysterious Island,WB (NL),2012,103900000,231400000,335300000
751,The Expendables 2,LGF,2012,85000000,229900000,314900000
752,Rise of the Guardians,P/DW,2012,103400000,203500000,306900000
753,Wrath of the Titans,WB,2012,83700000,221600000,305300000
754,Battleship,Uni.,2012,65400000,237600000,303000000
755,John Carter,BV,2012,73100000,211100000,284200000
756,The Bourne Legacy,Uni.,2012,113200000,162900000,276100000
757,Lincoln,BV,2012,182200000,93100000,275300000
758,Dark Shadows,WB,2012,79700000,165800000,245500000
759,Resident Evil: Retribution,SGem,2012,42300000,197700000,240000000
760,Silver Linings Playbook,Wein.,2012,132100000,104300000,236400000
761,American Reunion,Uni.,2012,57000000,178000000,235000000
762,Argo,WB,2012,136000000,96300000,232300000
763,Jack Reacher,Par.,2012,80100000,138300000,218400000
764,Safe House,Uni.,2012,126400000,81700000,208100000
765,21 Jump Street,Sony,2012,138400000,63100000,201500000
766,Total Recall (2012),Sony,2012,58900000,139600000,198500000
767,The Vow,SGem,2012,125000000,71100000,196100000
768,Mirror Mirror,Rela.,2012,64900000,118100000,183000000
769,The Impossible,LG/S,2012,19000000,161300000,180300000
770,The Dictator,Par.,2012,59700000,119700000,179400000
771,Looper,TriS,2012,66500000,110000000,176500000
772,Magic Mike,WB,2012,113700000,53500000,167200000
773,Flight,Par.,2012,93800000,68000000,161800000
774,Underworld Awakening,SGem,2012,62300000,97800000,160100000
775,This Means War,Fox,2012,54800000,101700000,156500000
776,The Secret World of Arrietty,BV,2012,19200000,126400000,145600000
777,Paranormal Activity 4,Par.,2012,53900000,88900000,142800000
778,Step Up Revolution,LG/S,2012,35100000,105400000,140500000
779,The Best Exotic Marigold Hotel,FoxS,2012,46400000,90400000,136800000
780,Zero Dark Thirty,Sony,2012,95700000,37100000,132800000
781,Ghost Rider: Spirit of Vengeance,Sony,2012,51800000,80800000,132600000
782,Cloud Atlas,WB,2012,27100000,103400000,130500000
783,The Woman in Black,CBS,2012,54300000,73400000,127700000
784,Chronicle (2012),Fox,2012,64599999,62100000,126699999
785,The Pirates! Band of Misfits,Sony,2012,31100000,92000000,123100000
786,Parental Guidance,Fox,2012,77300000,42500000,119800000
787,Abraham Lincoln: Vampire Hunter,Fox,2012,37500000,79000000,116500000
788,Pitch Perfect,Uni.,2012,65000000,50300000,115300000
789,Hope Springs,Sony,2012,63500000,50700000,114200000
790,ParaNorman,Focus,2012,56000000,51100000,107100000
791,The Campaign,WB,2012,86900000,18000000,104900000
792,Let the Bullets Fly,Vari.,2012,63000,104300000,104363000
793,Star Wars: Episode I - The Phantom Menace (in 3D),Fox,2012,43500000,59300000,102800000
794,Project X,WB,2012,54700000,48000000,102700000
795,The Devil Inside,Par.,2012,53300000,48500000,101800000
796,The Lucky One,WB,2012,60500000,38900000,99400000
797,Contraband,Uni.,2012,66500000,29700000,96200000
798,Think Like a Man,SGem,2012,91500000,4500000,96000000
799,This Is 40,Uni.,2012,67500000,20500000,88000000
800,The Inbetweeners Movie,WHE,2012,36000,88000000,88036000
801,The Possession,LGF,2012,49100000,36300000,85400000
802,What to Expect When You're Expecting,LGF,2012,41200000,43200000,84400000
803,The Thieves,WGUSA,2012,686000,82800000,83486000
804,Savages (2012),Uni.,2012,47400000,35600000,83000000
805,Frankenweenie,BV,2012,35300000,46200000,81500000
806,Act of Valor,Rela.,2012,70000000,11300000,81300000
807,Masquerade (2012),CJ,2012,923000,79800000,80723000
808,Sinister,LG/S,2012,48100000,29600000,77700000
809,The Grey,ORF,2012,51600000,25700000,77300000
810,Diary of a Wimpy Kid: Dog Days,Fox,2012,49000000,28100000,77100000
811,To Rome with Love,SPC,2012,16700000,56600000,73300000
812,Here Comes the Boom,Sony,2012,45300000,27800000,73100000
813,Finding Nemo (3D),BV,2012,41100000,28200000,69300000
814,Anna Karenina,Focus,2012,12800000,56100000,68900000
815,The Watch,Fox,2012,35400000,32900000,68300000
816,Moonrise Kingdom,Focus,2012,45500000,22800000,68300000
817,Tyler Perry's Madea's Witness Protection,LGF,2012,65700000,1200000,66900000
818,The Cabin in the Woods,LGF,2012,42100000,24400000,66500000
819,Beauty and the Beast (3D),BV,2012,47600000,14400000,62000000
820,Rock of Ages,WB (NL),2012,38500000,20900000,59400000
821,That's My Boy,Sony,2012,36900000,20800000,57700000
822,The Odd Life of Timothy Green,BV,2012,51900000,4200000,56100000
823,The Three Stooges,Fox,2012,44300000,10500000,54800000
824,The Five-Year Engagement,Uni.,2012,28800000,25100000,53900000
825,Lawless,Wein.,2012,37400000,16300000,53700000
826,Silent Hill: Revelation 3D,ORF,2012,17500000,34800000,52300000
827,Red Tails,Fox,2012,49900000,489000,50389000
828,"Monsters, Inc. (3D)",BV,2012,34000000,16200000,50200000
829,Trouble with the Curve,WB,2012,35800000,13200000,49000000
830,Little White Lies,MPI,2012,206000,48300000,48506000
831,End of Watch,ORF,2012,41000000,7100000,48100000
832,Man on a Ledge,LG/S,2012,18600000,27600000,46200000
833,Red Dawn (2012),FD,2012,44800000,0,44800000
834,House at the End of The Street,Rela.,2012,31600000,12700000,44300000
835,The Guilt Trip,Par.,2012,37100000,4700000,41800000
836,A Werewolf Boy,CJ,2012,343000,41300000,41643000
837,Safe (2012),LGF,2012,17100000,23200000,40300000
838,Killing Them Softly,Wein.,2012,15000000,22900000,37900000
839,Chernobyl Diaries,WB,2012,18100000,19000000,37100000
840,One For the Money,LGF,2012,26400000,10500000,36900000
841,Dredd,LGF,2012,13400000,22200000,35600000
842,Tyler Perry's Good Deeds,LGF,2012,35000000,553000,35553000
843,Arbitrage,RAtt.,2012,7900000,27600000,35500000
844,Chimpanzee,BV,2012,29000000,5900000,34900000
845,Alex Cross,LG/S,2012,25900000,8700000,34600000
846,Salmon Fishing in the Yemen,CBS,2012,9000000,25500000,34500000
847,Fetih 1453: The Conquest of Constantinople,NeoC,2012,35700,34400000,34435700
848,Cirque Du Soleil: Worlds Away,Par.,2012,12500000,21600000,34100000
849,The Perks of Being a Wallflower,LG/S,2012,17700000,15600000,33300000
850,Haywire,Rela.,2012,18900000,14400000,33300000
851,Katy Perry: Part of Me,Par.,2012,25300000,7400000,32700000
852,Lockout,FD,2012,14300000,17900000,32200000
853,Joyful Noise,WB,2012,30900000,226000,31126000
854,Premium Rush,Sony,2012,20300000,10800000,31100000
855,The Raven,Rela.,2012,16000000,13600000,29600000
856,Rowdy Rathore,UTV,2012,777000,28600000,29377000
857,Dragon (2012),RTWC,2012,11100,29100000,29111100
858,Bol Bachchan,FIP,2012,1200000,27600000,28800000
859,The Master,Wein.,2012,16399999,11900000,28299999
860,Rust and Bone,SPC,2012,2100000,23700000,25800000
861,Big Miracle,Uni.,2012,20200000,4600000,24800000
862,Sparkle (2012),TriS,2012,24400000,240000,24640000
863,To the Arctic (IMAX),WB,2012,14600000,9100000,23700000
864,Hitchcock,FoxS,2012,6000000,17600000,23600000
865,A Thousand Words,P/DW,2012,18500000,3600000,22100000
866,Wanderlust,Uni.,2012,17500000,4200000,21700000
867,Beasts of the Southern Wild,FoxS,2012,12800000,8300000,21100000
868,Polisse,IFC,2012,211000,20200000,20411000
869,Amour,SPC,2012,6700000,13100000,19800000
870,The Man with the Iron Fists,Uni.,2012,15600000,4099999,19699999
872,Seven Psychopaths,CBS,2012,15000000,4400000,19400000
873,Gone,LG/S,2012,11700000,6400000,18100000
874,Norwegian Wood,RF,2012,13000,17600000,17613000
875,The Cold Light of Day,LG/S,2012,3800000,13100000,16900000
876,My Way (2012),CJ,2012,70200,16500000,16570200
877,Tomorrow When the War Began,Free,2012,4900,16500000,16504900
878,We Have a Pope,IFC,2012,548000,15600000,16148000
879,Headhunters,Magn.,2012,1200000,14500000,15700000
880,Hit and Run,ORF,2012,13700000,704000,14404000
881,War of the Buttons (2012),Wein.,2012,47800,13800000,13847800
882,Red Lights (2012),MNE,2012,52600,13500000,13552600
883,The Words,CBS,2012,11500000,1700000,13200000
884,Playing for Keeps,FD,2012,13100000,0,13100000
885,Silent House,ORF,2012,12800000,347000,13147000
886,Friends with Kids,RAtt.,2012,7300000,5800000,13100000
887,The Well-Digger's Daughter,KL,2012,386000,12200000,12586000
888,Klown,Drft.,2012,68800,12400000,12468800
889,People Like Us,BV,2012,12400000,0,12400000
890,Seeking Justice,Anch.,2012,412000,11900000,12312000
891,Bachelorette,RTWC,2012,448000,11500000,11948000
892,This Must Be the Place,Wein.,2012,144000,11600000,11744000
893,Fun Size,Par.,2012,9400000,2000000,11400000
894,Rec 3: Genesis,Magn.,2012,9600,10100000,10109600
895,Delicacy,Cohen,2012,499000,9200000,9699000
896,Seeking a Friend for the End of the World,Focus,2012,7100000,2600000,9700000
897,The Apparition,WB,2012,4900000,4700000,9600000
898,For Greater Glory,ArcEnt,2012,5700000,4000000,9700000
899,Hysteria,SPC,2012,1800000,7700000,9500000
900,Bernie,MNE,2012,9200000,0,9200000
901,The Sessions,FoxS,2012,6000000,3100000,9100000
902,Ruby Sparks,FoxS,2012,2500000,6600000,9100000
903,Hyde Park on Hudson,Focus,2012,6400000,2500000,8900000
904,On the Road,IFC,2012,744000,8000000,8744000
905,Boy (2012),PalUni,2012,256000,8400000,8656000
906,Piranha 3DD,W/Dim.,2012,377000,8100000,8477000
907,Easy Money (2012),Wein.,2012,206000,8199999,8405999
908,Space Dogs 3D,EpicPics,2012,14400,8300000,8314400
909,Bel Ami,Magn.,2012,120000,8199999,8319999
910,Promised Land (2012),Focus,2012,7600000,541000,8141000
911,Iron Sky,EOne,2012,122000,8000000,8122000
912,Casa De Mi Padre,LGF,2012,5900000,2100000,8000000
913,Heroine,UTV,2012,599000,7400000,7999000
914,A Royal Affair,Magn.,2012,1500000,6000000,7500000
915,All Together,KL,2012,43200,7200000,7243200
916,My Worst Nightmare,Strand,2012,22000,7100000,7122000
917,The Collection,LD,2012,6800000,0,6800000
918,Monsieur Lazhar (U.S.-only),MBox,2012,2000000,4600000,6600000
919,Goon,Magn.,2012,4200000,2300000,6500000
920,Cosmopolis,EOne,2012,764000,5300000,6064000
921,Chasing Mavericks,Fox,2012,6000000,600,6000600
922,Declaration of War,IFC,2012,59100,5800000,5859100
923,Puella Magi Madoka Magica the Movie,Elev.,2012,180000,5600000,5780000
924,Albert Nobbs,RAtt.,2012,3000000,2600000,5600000
925,In Darkness,SPC,2012,1000000,4500000,5500000
926,Won't Back Down,Fox,2012,5300000,0,5300000
927,Farewell My Queen,Cohen,2012,1600000,3700000,5300000
929,Girl in Progress,LGF,2012,2600000,2000000,4600000
930,"Jeff, Who Lives at Home",ParV,2012,4300000,148000,4448000
931,Barbara,AF,2012,1000000,3100000,4100000
932,The Raid: Redemption,SPC,2012,4099999,0,4099999
934,Safety Not Guaranteed,FD,2012,4000000,0,4000000
935,Nitro Circus the Movie 3D,ArcEnt,2012,3400000,526000,3926000
937,The Lady,Cohen,2012,355000,3400000,3755000
938,Branded,RAtt.,2012,354000,3400000,3754000
939,The Rabbi's Cat,GK,2012,23400,3700000,3723400
940,Searching for Sugar Man,SPC,2012,3700000,0,3700000
941,Killer Joe,LD,2012,2000000,1700000,3700000
942,Hara-Kiri: Death of a Samurai,Trib.,2012,75700,3400000,3475700
943,Robot & Frank,Gold.,2012,3300000,0,3300000
944,Raiders of the Lost Ark (IMAX),Par.,2012,3100000,0,3100000
945,Celeste and Jesse Forever,SPC,2012,3100000,0,3100000
946,Jab Tak Hai Jaan,Yash,2012,3000000,0,3000000
947,Intruders,MNE,2012,69100,2900000,2969100
948,Talaash,Relbig.,2012,2900000,0,2900000
949,Barfi!,UTV,2012,2800000,0,2800000
950,A Simple Life,CL,2012,192000,2600000,2792000
951,Samsara,Osci.,2012,2700000,0,2700000
952,Simon and the Oaks,TFA,2012,151000,2400000,2551000
953,Jiro Dreams of Sushi,Magn.,2012,2600000,0,2600000
954,Dabangg 2,Eros,2012,2500000,0,2500000
955,Kid With a Bike,IFC,2012,1500000,1000000,2500000
956,The Queen of Versailles,Magn.,2012,2400000,0,2400000
957,Ek Tha Tiger,Yash,2012,2300000,0,2300000
958,Chico & Rita,GK,2012,351000,1900000,2251000
959,Stolen (2012),MNE,2012,304000,1800000,2104000
960,Footnote,SPC,2012,2000000,0,2000000
961,The Imposter,IM,2012,898000,1100000,1998000
962,Agneepath,Eros,2012,2000000,0,2000000
963,The Day I Saw Your Heart,FM,2012,3500,2000000,2003500
964,English Vinglish,Eros,2012,1900000,0,1900000
965,Housefull 2,Eros,2012,1800000,0,1800000
967,Tales of the Night,GK,2012,11000,1700000,1711000
968,Beloved (2012),IFC,2012,138000,1500000,1638000
969,360,Magn.,2012,100000,1600000,1700000
970,2 Days in New York,Magn.,2012,633000,1000000,1633000
971,Your Sister's Sister,IFC,2012,1600000,0,1600000
972,Hermano,MBox,2012,29900,1600000,1629900
973,Lay the Favorite,RTWC,2012,21000,1600000,1621000
974,Soldiers of Fortune,RAtt.,2012,38900,1500000,1538900
975,A Late Quartet,EOne,2012,1600000,0,1600000
976,I Wish,Magn.,2012,146000,1400000,1546000
977,The Salt of Life,Zeit.,2012,317000,1200000,1517000
978,Chicken with Plums,SPC,2012,254000,1200000,1454000
979,Marley,Magn.,2012,1400000,0,1400000
980,The Paperboy,MNE,2012,693000,661000,1354000
981,Chasing Ice,SD,2012,1300000,0,1300000
982,Unforgivable,Strand,2012,154000,1200000,1354000
983,A Little Bit of Heaven,MNE,2012,15400,1300000,1315400
984,The Other Son,Cohen,2012,1300000,0,1300000
985,Meerkats,NGE,2012,778000,482000,1260000
986,"For a Good Time, Call...",Focus,2012,1300000,0,1300000
987,Take This Waltz,Magn.,2012,1200000,0,1200000
988,Cocktail (2012),Eros,2012,1200000,0,1200000
989,Once Upon a Time in Anatolia,CGld,2012,152000,1000000,1152000
990,Ek Main Aur Ekk Tu,UTV,2012,1200000,0,1200000
991,The Deep Blue Sea,MBox,2012,1100000,0,1100000
992,Coriolanus,Wein.,2012,757000,315000,1072000
993,Diana Vreeland: The Eye Has to Travel,Gold.,2012,1000000,0,1000000
994,First Position,IFC,2012,1000000,0,1000000
995,Damsels in Distress,SPC,2012,1000000,0,1000000
996,Rampart,MNE,2012,973000,0,973000
997,Elles,KL,2012,158000,754000,912000
998,W.E.,Wein.,2012,583000,285000,868000
999,Breathing,KL,2012,4600,803000,807600
1000,Darling Companion,SPC,2012,794000,0,794000
1001,Teri Meri Kahaani,Eros,2012,781000,0,781000
1002,Son of Sardaar,Eros,2012,772000,0,772000
1003,Agent Vinod,Eros,2012,698000,0,698000
1004,Student of the Year,Eros,2012,670000,0,670000
1005,The Polar Express (2012 re-issue),WB,2012,669000,0,669000
1006,Holy Motors,IM,2012,641000,0,641000
1007,Free Men,FM,2012,53800,564000,617800
1008,"Peace, Love and Misunderstanding",IFC,2012,591000,0,591000
1009,Undefeated (2012),Wein.,2012,562000,0,562000
1010,Sister (2012),AF,2012,155000,400000,555000
1011,Vicky Donor,Eros,2012,549000,0,549000
1012,Being Flynn,Focus,2012,540000,0,540000
1013,Ai Weiwei: Never Sorry,IFC,2012,534000,0,534000
1014,Where Do We Go Now?,SPC,2012,532000,0,532000
1015,Bully (2012),Wein.,2012,279000,182000,461000
1016,Ferrari Ki Sawaari,Eros,2012,434000,0,434000
1018,Apartment 143,Magn.,2012,400,426000,426400
1019,Sound of My Voice,FoxS,2012,408000,0,408000
1020,Khiladi 786,Eros,2012,379000,0,379000
1021,Smashed,SPC,2012,377000,0,377000
1022,Universal Soldier: Day of Reckoning,Magn.,2012,5500,364000,369500
1023,The Oranges,ATO,2012,366000,0,366000
1024,Liberal Arts,IFC,2012,327000,0,327000
1025,Compliance,Magn.,2012,319000,0,319000
1026,Back to 1942,CL,2012,313000,0,313000
1027,The Flowers of War,WHE,2012,311000,0,311000
1028,Something From Nothing: The Art of Rap,IM,2012,288000,0,288000
1029,Love in the Buff,CL,2012,256000,0,256000
1030,Lola Versus,FoxS,2012,253000,0,253000
1031,Keep the Lights On,MBox,2012,246000,0,246000
1032,Gerhard Richter Painting,KL,2012,243000,0,243000
1033,Trishna,IFC,2012,240000,0,240000
1034,Elena,Zeit.,2012,233000,0,233000
1035,Tezz,Eros,2012,230000,0,230000
1036,The Viral Factor,CL,2012,220000,0,220000
1037,Neil Young Journeys,SPC,2012,215000,0,215000
1038,Tai Chi Zero,Vari.,2012,212000,0,212000
1039,The House I Live In,Abr.,2012,211000,0,211000
1040,10 Years,Anch.,2012,203000,0,203000
1041,17 Girls,Strand,2012,15100,186000,201100
1042,Tim & Eric's Billion Dollar Movie,Magn.,2012,201000,0,201000
1043,Any Day Now,MBox,2012,201000,0,201000
1044,Tere Naal Love Ho Gaya,UTV,2012,178000,0,178000
1045,The Hunter (2012),Magn.,2012,177000,0,177000
1046,Butter,RTWC,2012,105000,70700,175700
1047,Kill List,IFC,2012,29100,143000,172100
1048,Flying Swords of Dragon Gate,IM,2012,170000,0,170000
1049,Joker,UTV,2012,169000,0,169000
1050,Dark Horse,BM&DH,2012,166000,0,166000
1051,Shirin Farhad Ki Toh Nikal Padi,Eros,2012,156000,0,156000
1052,Bullhead,Drft.,2012,152000,0,152000
1053,Chakravyuh,Eros,2012,152000,0,152000
1054,Luv Shuv Tey Chicken Khurana,UTV,2012,144000,0,144000
1055,High School,Anch.,2012,139000,0,139000
1056,Warriors of the Rainbow: Seediq Bale,WGUSA,2012,136000,0,136000
1057,The Loneliest Planet,IFC,2012,130000,0,130000
1058,Forgiveness of Blood,IFC,2012,127000,0,127000
1059,Toys in the Attic,Hann.,2012,64900,61600,126500
1060,"Turn Me On, Dammit!",NYer,2012,126000,0,126000
1061,God Bless America,Magn.,2012,123000,0,123000
1062,Bullet Vanishes,CL,2012,118000,0,118000
1063,The Woman in the Fifth,ATO,2012,114000,0,114000
1064,5 Broken Cameras,KL,2012,110000,0,110000
1065,Hello I Must Be Going,Osci.,2012,107000,0,107000
1066,The Magic of Belle Isle,Magn.,2012,102000,0,102000
1067,"Oslo, August 31st",Strand,2012,101000,0,101000
1068,Wuthering Heights (2012),Osci.,2012,101000,0,101000
1069,Mugamoodi,UTV,2012,101000,0,101000
1070,V/H/S,Magn.,2012,100000,0,100000
1071,Goodbye First Love,IFC,2012,95000,0,95000
1072,Marina Abramovic: The Artist is Present,MBox,2012,86600,0,86600
1073,The Eye of the Storm,SEG,2012,83600,0,83600
1074,Wagner & Me,FRun,2012,37700,41000,78700
1075,The Innkeepers,Magn.,2012,78400,0,78400
1076,This is Not a Film,PalT,2012,77000,0,77000
1077,The Island President,Gold.,2012,76400,0,76400
1078,Detachment,Trib.,2012,72700,0,72700
1080,Attenberg,Strand,2012,24000,45900,69900
1081,Deadfall (2012),Magn.,2012,66400,0,66400
1082,Girlfriend Boyfriend - GF BF,CL,2012,64400,0,64400
1083,Vulgaria,CL,2012,59100,0,59100
1084,The Turin Horse,CGld,2012,56400,0,56400
1085,Jodi Breakers,Yash,2012,52600,0,52600
1086,Painted Skin: The Resurrection,WGUSA,2012,50400,0,50400
1087,"All's Well, End's Well (2012)",CL,2012,47900,0,47900
1088,North Sea Texas,Strand,2012,28300,16700,45000
1089,Double Trouble,CL,2012,44800,0,44800
1090,The Fairy,KL,2012,38400,0,38400
1091,Hit So Hard,Vari.,2012,34000,0,34000
1092,Kalakalappu@Masala Cafe,UTV,2012,30900,0,30900
1093,The Bay,RAtt.,2012,30700,0,30700
1094,You've Been Trumped,ICir,2012,29300,0,29300
1095,Here (2012),Strand,2012,26700,0,26700
1096,In Another Country,KL,2012,25100,0,25100
1097,The First Time,Gold.,2012,22800,0,22800
1098,Bonsai,Strand,2012,21300,0,21300
1099,The Day,Anch.,2012,21000,0,21000
1100,28 Hotel Rooms,Osci.,2012,18900,0,18900
1101,Lovely Molly,Imag.,2012,18500,0,18500
1102,Juan of the Dead,Outs,2012,18000,0,18000
1103,4:44: Last Day on Earth,IFC,2012,17800,0,17800
1104,Little Birds,MNE,2012,17700,0,17700
1105,Return (2012),Da.,2012,16100,0,16100
1106,Alps,KL,2012,16100,0,16100
1107,Patience (After Sebald),CGld,2012,15900,0,15900
1108,Take Me Home,Mont.,2012,15800,0,15800
1109,Reuniting the Rubins,Mont.,2012,13600,0,13600
1110,Cirkus Columbia,Strand,2012,3500,9500,13000
1111,Grassroots,Gold.,2012,12400,0,12400
1112,Husbands in Goa,UTV,2012,10100,0,10100
1113,Starry Starry Night,CL,2012,10000,0,10000
1114,Corpo Celeste,FM,2012,8900,0,8900
1115,Dreams of a Life,Strand,2012,8400,0,8400
1116,The Babymakers,MNE,2012,7900,0,7900
1117,Las Acacias,OutF,2012,6000,0,6000
1118,The Good Doctor,Magn.,2012,5200,0,5200
1119,Liar's Autobiography,BSM,2012,5100,0,5100
1120,Sleepless Night,Trib.,2012,3400,0,3400
1121,ATM,IFC,2012,3000,0,3000
1122,About Cherry,IFC,2012,3000,0,3000
1123,Perfect Sense,IFC,2012,3000,0,3000
1124,Cheerful Weather for the Wedding,IFC,2012,2700,0,2700
1125,The Decoy Bride,IFC,2012,800,0,800
1126,Death of a Superhero,Trib.,2012,600,0,600
1127,Frozen,BV,2013,400700000,875700000,1276400000
1128,Iron Man 3,BV,2013,409000000,805800000,1214800000
1129,Despicable Me 2,Uni.,2013,368100000,602700000,970800000
1130,The Hobbit: The Desolation of Smaug,WB (NL),2013,258399999,700000000,958399999
1131,The Hunger Games: Catching Fire,LGF,2013,424700000,440300000,865000000
1132,Fast & Furious 6,Uni.,2013,238700000,550000000,788700000
1133,Monsters University,BV,2013,268500000,475700000,744200000
1134,Gravity,WB,2013,274100000,449100000,723200000
1135,Man of Steel,WB,2013,291000000,377000000,668000000
1136,Thor: The Dark World,BV,2013,206400000,438200000,644600000
1137,The Croods,Fox,2013,187200000,400000000,587200000
1138,World War Z,Par.,2013,202400000,337600000,540000000
1139,Oz The Great and Powerful,BV,2013,234900000,258399999,493299999
1140,Star Trek Into Darkness,Par.,2013,228800000,238600000,467400000
1141,The Wolverine,Fox,2013,132600000,282300000,414900000
1142,Pacific Rim,WB,2013,101800000,309200000,411000000
1143,The Wolf of Wall Street,Par.,2013,116900000,275100000,392000000
1144,G.I. Joe: Retaliation,Par.,2013,122500000,253200000,375700000
1145,The Hangover Part III,WB,2013,112200000,249800000,362000000
1146,The Great Gatsby (2013),WB,2013,144800000,208800000,353600000
1147,Now You See Me,LG/S,2013,117700000,234000000,351700000
1148,The Smurfs 2,Sony,2013,71000000,276500000,347500000
1149,The Conjuring,WB (NL),2013,137400000,182100000,319500000
1150,A Good Day to Die Hard,Fox,2013,67300000,237300000,304600000
1151,Oblivion,Uni.,2013,89100000,197100000,286200000
1152,Elysium,TriS,2013,93100000,193100000,286200000
1153,Turbo,Fox,2013,83000000,199500000,282500000
1154,Cloudy with a Chance of Meatballs 2,Sony,2013,119800000,154500000,274300000
1155,We're the Millers,WB (NL),2013,150400000,119600000,270000000
1156,Epic,Fox,2013,107500000,160900000,268400000
1157,The Lone Ranger,BV,2013,89300000,171200000,260500000
1158,American Hustle,Sony,2013,150100000,101100000,251200000
1159,Grown Ups 2,Sony,2013,133699999,113300000,246999999
1160,After Earth,Sony,2013,60500000,183300000,243800000
1161,Planes,BV,2013,90300000,149000000,239300000
1162,The Heat,Fox,2013,159600000,70300000,229900000
1163,Hansel and Gretel: Witch Hunters,Par.,2013,55700000,170600000,226300000
1164,Captain Phillips,Sony,2013,107100000,111700000,218800000
1165,White House Down,Sony,2013,73100000,132300000,205400000
1166,Percy Jackson: Sea of Monsters,Fox,2013,68600000,131300000,199900000
1167,Lost in Thailand,WAMCR,2013,57400,197700000,197757400
1168,Jack the Giant Slayer,WB (NL),2013,65200000,132500000,197700000
1169,The Secret Life of Walter Mitty,Fox,2013,58200000,129900000,188100000
1170,12 Years a Slave,FoxS,2013,56700000,131100000,187800000
1171,Lee Daniels' The Butler,Wein.,2013,116600000,60000000,176600000
1172,Identity Thief,Uni.,2013,134500000,39500000,174000000
1173,Anchorman 2: The Legend Continues,Par.,2013,125200000,46300000,171500000
1174,Olympus Has Fallen,FD,2013,98900000,71300000,170200000
1175,Insidious Chapter 2,FD,2013,83600000,78300000,161900000
1176,Lone Survivor,Uni.,2013,125100000,29700000,154800000
1177,Jackass Presents: Bad Grandpa,Par.,2013,102000000,49800000,151800000
1178,47 Ronin,Uni.,2013,38400000,113400000,151800000
1179,Red 2,LG/S,2013,53300000,94800000,148100000
1180,Mama,Uni.,2013,71600000,74800000,146400000
1181,Escape Plan,LG/S,2013,25100000,112200000,137300000
1182,Last Vegas,CBS,2013,63900000,70500000,134400000
1183,2 Guns,Uni.,2013,75600000,56300000,131900000
1184,Walking with Dinosaurs,Fox,2013,36100000,90500000,126600000
1185,This is the End,Sony,2013,101500000,24600000,126100000
1186,Ender's Game,LG/S,2013,61700000,63800000,125500000
1187,Prisoners,WB,2013,61000000,61100000,122100000
1188,Saving Mr. Banks,BV,2013,83300000,34600000,117900000
1189,Warm Bodies,LG/S,2013,66400000,50600000,117000000
1190,Jurassic Park 3D,Uni.,2013,45400000,71100000,116500000
1191,Personal Tailor,CL,2013,376000,115800000,116176000
1192,Free Birds,Rela.,2013,55800000,54600000,110400000
1193,Gangster Squad,WB,2013,46000000,59200000,105200000
1194,Philomena,Wein.,2013,37700000,62400000,100100000
1195,Instructions Not Included,LGF,2013,44500000,54600000,99100000
1196,Riddick,Uni.,2013,42000000,56300000,98300000
1197,Safe Haven,Rela.,2013,71300000,26200000,97500000
1198,Evil Dead (2013),TriS,2013,54200000,43300000,97500000
1199,Blue Jasmine,SPC,2013,33400000,64099999,97499999
1200,The Mortal Instruments: City of Bones,SGem,2013,31200000,64200000,95400000
1201,The Internship,Fox,2013,44700000,48800000,93500000
1202,Rush (2013),Uni.,2013,26900000,63300000,90200000
1203,The Purge,Uni.,2013,64500000,24900000,89400000
1204,Dhoom 3,Yash,2013,8000000,80000000,88000000
1205,About Time,Uni.,2013,15300000,71800000,87100000
1206,Pain and Gain,Par.,2013,49900000,36300000,86200000
1207,Carrie (2013),SGem,2013,35300000,49500000,84800000
1208,The Family (2013),Rela.,2013,36900000,41500000,78400000
1209,Scary Movie 5,W/Dim.,2013,32000000,46400000,78400000
1210,R.I.P.D.,Uni.,2013,33600000,44700000,78300000
1211,Tiny Times,CL,2013,23500,77700000,77723500
1212,The Book Thief,Fox,2013,21500000,55100000,76600000
1213,Escape From Planet Earth,Wein.,2013,57000000,17600000,74600000
1214,August: Osage County,Wein.,2013,37700000,36500000,74200000
1215,The Best Man Holiday,Uni.,2013,70500000,2300000,72800000
1216,Young Detective Dee: Rise of the Sea Dragon,WAMCR,2013,87800,72200000,72287800
1217,The Counselor,Fox,2013,17000000,54000000,71000000
1218,The Call,TriS,2013,51900000,16700000,68600000
1219,One Direction: This is Us,TriS,2013,28900000,39700000,68600000
1220,The Grandmaster,Wein.,2013,6600000,57500000,64100000
1221,Side Effects (2013),ORF,2013,32200000,31200000,63400000
1222,The Host (2013),ORF,2013,26600000,36700000,63300000
1223,Runner Runner,Fox,2013,19300000,43400000,62700000
1224,From Up on Poppy Hill,GK,2013,1000000,60000000,61000000
1225,Kick-Ass 2,Uni.,2013,28800000,32000000,60800000
1226,A Haunted House,ORF,2013,40000000,20100000,60100000
1227,Beautiful Creatures (2013),WB,2013,19500000,40600000,60100000
1228,Quartet,Wein.,2013,18400000,41100000,59500000
1229,Dallas Buyers Club,Focus,2013,27300000,27900000,55200000
1230,The Face Reader,PM&E,2013,516000,54100000,54616000
1231,Tyler Perry's A Madea Christmas,LGF,2013,52500000,853000,53353000
1232,Tyler Perry's Temptation: Confessions of a Marriage Counselor,LGF,2013,52000000,1200000,53200000
1233,Delivery Man,BV,2013,30700000,19300000,50000000
1234,The Berlin File,CJ,2013,665000,48300000,48965000
1235,The Last Stand,LGF,2013,12100000,36300000,48400000
1236,21 and Over,Rela.,2013,25700000,22400000,48100000
1237,Her (2013),WB,2013,25600000,21800000,47400000
1238,Tiny Times 2,CL,2013,43800,47200000,47243800
1239,Texas Chainsaw 3D,LGF,2013,34300000,12900000,47200000
1240,The Big Wedding,LGF,2013,21800000,24700000,46500000
1241,Parker,FD,2013,17600000,28600000,46200000
1242,The World's End,Focus,2013,26000000,20100000,46100000
1243,Grudge Match,WB,2013,29800000,15100000,44900000
1244,Homefront,ORF,2013,20200000,22900000,43100000
1245,Snitch,LG/S,2013,42900000,0,42900000
1246,Jobs,ORF,2013,16100000,19800000,35900000
1247,The Place Beyond the Pines,Focus,2013,21400000,14100000,35500000
1248,Inside Llewyn Davis,CBS,2013,13200000,19700000,32900000
1249,Mud,RAtt.,2013,21600000,11000000,32600000
1250,Movie 43,Rela.,2013,8800000,23600000,32400000
1251,Kevin Hart: Let Me Explain,LG/S,2013,32200000,74000,32274000
1252,Spring Breakers,A24,2013,14100000,17600000,31700000
1253,New World (2013),WGUSA,2013,458000,31200000,31658000
1254,Don Jon,Rela.,2013,24500000,6000000,30500000
1255,I Give It a Year,Magn.,2013,34700,28200000,28234700
1256,Nebraska,Par.,2013,17700000,10000000,27700000
1257,The Incredible Burt Wonderstone,WB (NL),2013,22500000,4900000,27400000
1258,Mandela: Long Walk to Freedom,Wein.,2013,8300000,19000000,27300000
1259,Khumba,MNE,2013,1000,27200000,27201000
1260,Dark Skies,W/Dim.,2013,17400000,9000000,26400000
1261,Enough Said,FoxS,2013,17600000,7700000,25300000
1262,Trance,FoxS,2013,2300000,21900000,24200000
1263,"The Way, Way Back",FoxS,2013,21500000,1700000,23200000
1264,Kon-Tiki,Wein.,2013,1500000,21300000,22800000
1265,Baggage Claim,FoxS,2013,21600000,887000,22487000
1266,Diana,EOne,2013,335000,21400000,21735000
1267,The Great Beauty,Jan.,2013,2900000,18500000,21400000
1269,The Sapphires,Wein.,2013,2500000,18000000,20500000
1270,Broken City,Fox,2013,19700000,0,19700000
1271,The Company You Keep,SPC,2013,5100000,14500000,19600000
1272,The Bling Ring,A24,2013,5800000,13300000,19100000
1273,You're Next,LGF,2013,18500000,0,18500000
1274,Dead Man Down,FD,2013,10900000,7200000,18100000
1275,Admission,Focus,2013,18000000,0,18000000
1276,Fruitvale Station,Wein.,2013,16100000,1300000,17400000
1277,Battle of the Year,SGem,2013,8900000,7700000,16600000
1278,Out of the Furnace,Rela.,2013,11300000,4300000,15600000
1279,Billy and Buddy,Distrib.,2013,900,15200000,15200900
1280,The Last Exorcism Part II,CBS,2013,15200000,0,15200000
1281,Machete Kills,ORF,2013,8000000,7000000,15000000
1282,Journey to the South Pacific,Imax,2013,7600000,6500000,14100000
1283,Paranoia,Rela.,2013,7400000,6400000,13800000
1284,All Is Lost,RAtt.,2013,6300000,7400000,13700000
1285,Puella Magi Madoka Magica the Movie: Rebellion,Elev.,2013,376000,12600000,12976000
1286,Stoker,FoxS,2013,1700000,10400000,12100000
1287,In the House,Cohen,2013,390000,11500000,11890000
1288,I'm So Excited,SPC,2013,1400000,10400000,11800000
1289,Haute Cuisine,Wein.,2013,218000,11200000,11418000
1290,Before Midnight,SPC,2013,8100000,3100000,11200000
1291,Only God Forgives,RTWC,2013,779000,9900000,10679000
1292,The Past,SPC,2013,1300000,9300000,10600000
1293,Love is All You Need,SPC,2013,1600000,8400000,10000000
1294,Bullet to the Head,WB,2013,9500000,0,9500000
1295,Tyler Perry Presents Peeples,LGF,2013,9200000,130000,9330000
1296,Jerusalem,NGE,2013,8000000,1300000,9300000
1297,The Fifth Estate,BV,2013,3300000,5300000,8600000
1298,Upside Down,MNE,2013,105000,8000000,8105000
1299,Metallica Through the Never,PH,2013,3400000,4600000,8000000
1300,Pulling Strings,LGF,2013,5800000,2000000,7800000
1301,Black Nativity,FoxS,2013,7000000,436000,7436000
1302,Blue Is the Warmest Color,IFC,2013,2200000,5200000,7400000
1303,Unfinished Song,Wein.,2013,1700000,5300000,7000000
1304,The Angels' Share,IFC,2013,347000,6700000,7047000
1305,The Spectacular Now,A24,2013,6900000,0,6900000
1306,The Sweeney,EOne,2013,26700,6300000,6326700
1307,Believe,ORF,2013,6200000,0,6200000
1309,Closed Circuit,Focus,2013,5800000,0,5800000
1310,Populaire,Wein.,2013,179000,5300000,5479000
1311,Broken Circle Breakdown,Trib.,2013,175000,5300000,5475000
1312,Fists of Legend,CJ,2013,134000,5300000,5434000
1313,Chennai Express,UTV,2013,5300000,0,5300000
1314,20 Feet from Stardom,RTWC,2013,4900000,0,4900000
1315,Oldboy (2013),FD,2013,2200000,2700000,4900000
1316,Commitment,WGUSA,2013,76500,4500000,4576500
1317,White Elephant,Strand,2013,8900,4400000,4408900
1318,Much Ado About Nothing (2013),RAtt.,2013,4300000,0,4300000
1319,Frances Ha,IFC,2013,4099999,0,4099999
1320,You Will Be My Son,Cohen,2013,285000,3600000,3885000
1321,Yeh Jawaani Hai Deewani,Eros,2013,3800000,0,3800000
1322,Pieta,Drft.,2013,22100,3600000,3622100
1323,Mental,Da.,2013,17700,3600000,3617700
1324,The To-Do List,CBS,2013,3500000,74600,3574600
1325,Mr. Nobody,Magn.,2013,3600,3500000,3503600
1326,Emperor,RAtt.,2013,3300000,0,3300000
1327,Stand Up Guys,LGF,2013,3300000,0,3300000
1328,In a World,RAtt.,2013,3000000,0,3000000
1329,Ram-Leela,Eros,2013,2700000,0,2700000
1330,Capital,Cohen,2013,102000,2400000,2502000
1331,The East,FoxS,2013,2300000,99700,2399700
1332,I'm In Love With a Church Girl,HTR,2013,2400000,0,2400000
1333,No (2013),SPC,2013,2300000,0,2300000
1334,Renoir,Gold.,2013,2300000,0,2300000
1335,The Christmas Candle,ELS,2013,2300000,0,2300000
1336,Reality (2013),Osci.,2013,72600,2200000,2272600
1337,Krrish 3,Eros,2013,2200000,0,2200000
1338,Austenland,SPC,2013,2200000,0,2200000
1339,The Sorcerer and the White Snake,Magn.,2013,18800,2100000,2118800
1341,The Iceman (2013),MNE,2013,2000000,0,2000000
1343,Fill the Void,SPC,2013,1800000,0,1800000
1344,Starbuck (U.S. only),E1,2013,340000,1300000,1640000
1345,Bhaag Milkha Bhaag,Relbig.,2013,1600000,0,1600000
1346,Therese,MPI,2013,102000,1500000,1602000
1347,Stories We Tell,RAtt.,2013,1600000,0,1600000
1348,Lovelace,RTWC,2013,357000,1200000,1557000
1349,Race 2,UTV,2013,1600000,0,1600000
1350,Disconnect,LD,2013,1400000,0,1400000
1351,Girl Most Likely,RAtt.,2013,1400000,0,1400000
1352,Wadjda (U.S. only),SPC,2013,1300000,0,1300000
1353,The Kings of Summer,CBS,2013,1300000,0,1300000
1354,The Invisible Woman,SPC,2013,1200000,0,1200000
1355,Violeta Went to Heaven,KL,2013,21500,1200000,1221500
1356,Romeo and Juliet (2013),Rela.,2013,1200000,0,1200000
1357,Still Mine,Gold.,2013,1200000,0,1200000
1358,The Wall (2013),MBox,2013,38700,1100000,1138700
1359,Kai Po Che,UTV,2013,1100000,0,1100000
1360,What Maisie Knew,MNE,2013,1100000,0,1100000
1361,Thanks for Sharing,RAtt.,2013,1100000,0,1100000
1362,Ain't Them Bodies Saints,IFC,2013,397000,635000,1032000
1363,Kill Your Darlings,SPC,2013,1000000,0,1000000
1364,Short Term 12,Cdgm.,2013,1000000,0,1000000
1365,Ginger & Rosa,A24,2013,1000000,0,1000000
1366,Lore,MBox,2013,970000,0,970000
1367,Raanjhana,Eros,2013,903000,0,903000
1369,Generation Iron,TVC,2013,850000,0,850000
1370,The Monk,ATO,2013,13500,794000,807500
1371,Satyagraha,UTV,2013,739000,0,739000
1372,Hannah Arendt,Zeit.,2013,717000,0,717000
1373,Besharam,Relbig.,2013,680000,0,680000
1374,Salinger,Wein.,2013,584000,67000,651000
1375,The Hunt,Magn.,2013,613000,0,613000
1376,Walking the Camino: Six Ways to Santiago,FEF,2013,613000,0,613000
1377,To The Wonder,Magn.,2013,588000,0,588000
1378,Lootera,Eros,2013,582000,0,582000
1379,Museum Hours,CGld,2013,561000,0,561000
1380,The Reluctant Fundamentalist,IFC,2013,553000,0,553000
1381,You Ain't Seen Nothin' Yet,KL,2013,18900,488000,506900
1382,The Inevitable Defeat of Mister and Pete,LGF,2013,495000,0,495000
1383,Act of Killing,Drft.,2013,487000,0,487000
1384,Sound City,Vari.,2013,423000,0,423000
1385,Shadow Dancer,Magn.,2013,101000,319000,420000
1386,A Hijacking,Magn.,2013,414000,0,414000
1387,Grand Masti,Eros,2013,414000,0,414000
1388,Phata Poster Nikla Hero,Eros,2013,411000,0,411000
1389,The Armstrong Lie,SPC,2013,383000,0,383000
1390,Tai Chi Hero,WGUSA,2013,35100,347000,382100
1391,At Any Price,SPC,2013,381000,0,381000
1392,Shootout at Wadala,Eros,2013,370000,0,370000
1393,Gori Tere Pyaar Mein,Relbig.,2013,342000,0,342000
1394,Adore,EXCL,2013,319000,0,319000
1395,A Bottle in the Gaza Sea,FM,2013,5900,306000,311900
1396,Go Goa Gone,Eros,2013,298000,0,298000
1397,Blancanieves,Cohen,2013,280000,0,280000
1398,Himmatwala,UTV,2013,271000,0,271000
1399,Great Expectations (2013),MSF,2013,259000,0,259000
1400,The Silence,MBox,2013,100000,132000,232000
1401,Singh Saab The Great,Eros,2013,226000,0,226000
1402,ABCD (Any Body Can Dance),UTV,2013,222000,0,222000
1403,Arthur Newman,Cdgm.,2013,208000,0,208000
1404,Ghanchakkar,UTV,2013,203000,0,203000
1405,Midnight's Children,P/108,2013,190000,0,190000
1406,R... Rajkumar,Eros,2013,167000,0,167000
1407,We Steal Secrets: The Story of Wikileaks,FCW,2013,166000,0,166000
1408,The Patience Stone,SPC,2013,149000,0,149000
1409,Rangeelay,Eros,2013,148000,0,148000
1410,Drug War,Vari.,2013,128000,0,128000
1411,Beyond the Hills,IFC,2013,125000,0,125000
1412,Storm Surfers 3D,XL,2013,117000,0,117000
1413,Yossi,Strand,2013,117000,0,117000
1414,Spinning Plates,TFA,2013,112000,0,112000
1415,Ek Thi Daayan,Eros,2013,112000,0,112000
1416,The English Teacher,Cdgm.,2013,105000,0,105000
1417,Man of Tai Chi,RTWC,2013,100000,0,100000
1418,Passion,EOne,2013,92200,0,92200
1419,Byzantium,IFC,2013,89200,0,89200
1420,The Rooftop,WGUSA,2013,85800,0,85800
1421,We Are What We Are,EOne,2013,81400,0,81400
1422,Stuck in Love,MNE,2013,81100,0,81100
1423,More Than Honey,KL,2013,79800,0,79800
1424,Caesar Must Die,AF,2013,76900,0,76900
1425,Leviathan (2013),CGld,2013,76200,0,76200
1426,No One Lives,Anch.,2013,74900,0,74900
1427,War Witch,Trib.,2013,70500,0,70500
1428,The Pervert's Guide to Ideology,Zeit.,2013,68000,0,68000
1429,My Lucky Star,CL,2013,64400,0,64400
1430,Becoming Traviata,Distrib.,2013,62700,0,62700
1431,Sightseers,IFC,2013,61800,0,61800
1432,The Canyons,IFC,2013,56800,0,56800
1433,Table No. 21,Eros,2013,46700,0,46700
1434,Wish You Were Here (2013),EOne,2013,46300,0,46300
1435,A Glimpse Inside the Mind of Charles Swan III,A24,2013,45400,0,45400
1436,The We and the I,P/108,2013,42200,0,42200
1437,Killing Season,MNE,2013,39900,0,39900
1438,Post Tenebras Lux,Strand,2013,39200,0,39200
1439,Rising From Ashes,FRun,2013,38600,0,38600
1440,Berberian Sound Studio,IFC,2013,38500,0,38500
1441,Ip Man: The Final Fight,WGUSA,2013,37900,0,37900
1442,Redemption (2013),RAtt.,2013,36900,0,36900
1443,Camille Claudel 1915,KL,2013,35300,0,35300
1444,Bastards,IFC,2013,24500,0,24500
1445,Paradise: Love,Strand,2013,24300,0,24300
1446,Our Children,Distrib.,2013,23200,0,23200
1447,V/H/S/2,Magn.,2013,21800,0,21800
1448,The Look of Love,IFC,2013,21300,0,21300
1449,The Painting (2013),GK,2013,21000,0,21000
1450,Terraferma,Cohen,2013,20000,0,20000
1451,Love and Honor (2013),IFC,2013,19700,0,19700
1452,Nostalghia,KL,2013,18800,0,18800
1453,Casting By,SD,2013,18200,0,18200
1454,Violet & Daisy,Cdgm.,2013,17200,0,17200
1455,Jayne Mansfield's Car,Anch.,2013,14800,0,14800
1456,A Wedding Invitation,CJ,2013,14400,0,14400
1457,Red Obsession,A23,2013,13200,0,13200
1458,The Selfish Giant,IFC,2013,12200,0,12200
1459,Charlie Countryman,MNE,2013,11700,0,11700
1460,Just Like a Woman,Cohen,2013,11400,0,11400
1461,So Young,CL,2013,11200,0,11200
1462,In the Name Of,FM,2013,9900,0,9900
1463,InchAllah (U.S. only),EOne,2013,9800,0,9800
1464,Welcome to the Punch,IFC,2013,9700,0,9700
1465,Clandestine Childhood,IFC,2013,9000,0,9000
1466,Argento's Dracula 3D,IFC,2013,8100,0,8100
1467,Finding Mr. Right,CL,2013,6900,0,6900
1468,Paradise: Hope,Strand,2013,6700,0,6700
1469,Paradise: Faith,Strand,2013,6500,0,6500
1470,The Guillotines,WGUSA,2013,5300,0,5300
1471,The Stroller Strategy,Rialto,2013,3500,0,3500
1472,What Richard Did,Trib.,2013,2700,0,2700
1473,Caught in the Web,Vita.,2013,1100,0,1100
1474,I Spit on Your Grave 2,Anch.,2013,800,0,800
1475,Into the White,Magn.,2013,700,0,700
1476,Storage 24,Magn.,2013,100,0,100
1477,Transformers: Age of Extinction,Par.,2014,245400000,858600000,1104000000
1478,The Hobbit: The Battle of the Five Armies,WB (NL),2014,255100000,700900000,956000000
1479,Guardians of the Galaxy,BV,2014,333200000,440200000,773400000
1480,Maleficent,BV,2014,241400000,517100000,758500000
1481,The Hunger Games: Mockingjay - Part 1,LGF,2014,337100000,418200000,755300000
1482,X-Men: Days of Future Past,Fox,2014,233900000,513900000,747800000
1483,Captain America: The Winter Soldier,BV,2014,259800000,454500000,714300000
1484,Dawn of the Planet of the Apes,Fox,2014,208500000,502100000,710600000
1485,The Amazing Spider-Man 2,Sony,2014,202900000,506100000,709000000
1486,Interstellar,Par.,2014,188000000,489400000,677400000
1487,Big Hero 6,BV,2014,222500000,435300000,657800000
1488,How to Train Your Dragon 2,Fox,2014,177000000,444500000,621500000
1489,American Sniper,WB,2014,350100000,197300000,547400000
1490,Godzilla (2014),WB,2014,200700000,328400000,529100000
1491,Rio 2,Fox,2014,131500000,368600000,500100000
1492,Teenage Mutant Ninja Turtles (2014),Par.,2014,191200000,302100000,493300000
1493,The LEGO Movie,WB,2014,257800000,211400000,469200000
1494,Lucy,Uni.,2014,126700000,336700000,463400000
1495,Penguins of Madagascar,Fox,2014,83400000,289700000,373100000
1496,Edge of Tomorrow,WB,2014,100200000,270300000,370500000
1497,Gone Girl,Fox,2014,167800000,201600000,369400000
1498,Night at the Museum: Secret of the Tomb,Fox,2014,113700000,249500000,363200000
1499,Noah,Par.,2014,101200000,261399999,362599999
1500,The Maze Runner,Fox,2014,102400000,245900000,348300000
1501,300: Rise of An Empire,WB,2014,106600000,231000000,337600000
1502,22 Jump Street,Sony,2014,191700000,139600000,331300000
1503,The Fault in our Stars,Fox,2014,124900000,182300000,307200000
1504,Divergent,LG/S,2014,150900000,137900000,288800000
1505,Mr. Peabody & Sherman,Fox,2014,111500000,164200000,275700000
1506,Neighbors,Uni.,2014,150200000,120500000,270700000
1507,Exodus: Gods and Kings,Fox,2014,65000000,203200000,268200000
1508,Annabelle,WB (NL),2014,84300000,172800000,257100000
1509,Hercules (2014),Par.,2014,72700000,172100000,244800000
1510,RoboCop (2014),Sony,2014,58600000,184100000,242700000
1511,The Imitation Game,Wein.,2014,91100000,142400000,233500000
1512,Non-Stop,Uni.,2014,92200000,130600000,222800000
1513,Dracula Untold,Uni.,2014,56300000,160800000,217100000
1514,The Expendables 3,LGF,2014,39300000,175300000,214600000
1515,Into the Woods,BV,2014,128000000,85100000,213100000
1516,Fury (2014),Sony,2014,85800000,126000000,211800000
1517,Journey to the West,Magn.,2014,18100,205600000,205618100
1518,Need for Speed,BV,2014,43600000,159700000,203300000
1519,The Other Woman (2014),Fox,2014,83900000,112800000,196700000
1520,The Equalizer,Sony,2014,101500000,90800000,192300000
1521,Breakup Buddies,CL,2014,778000,188200000,188978000
1522,The Grand Budapest Hotel,FoxS,2014,59300000,115500000,174800000
1523,Dumb and Dumber To,Uni.,2014,86200000,83600000,169800000
1524,Unbroken,Uni.,2014,115600000,47800000,163400000
1525,Into The Storm,WB (NL),2014,47600000,114100000,161700000
1526,The Monuments Men,Sony,2014,78000000,77000000,155000000
1527,Ride Along,Uni.,2014,134900000,19500000,154400000
1528,Planes: Fire & Rescue,BV,2014,59200000,92200000,151400000
1529,Let's Be Cops,Fox,2014,82400000,55800000,138200000
1530,Jack Ryan: Shadow Recruit,Par.,2014,50600000,84900000,135500000
1531,Annie (2014),Sony,2014,85900000,47900000,133800000
1532,Blended,WB,2014,46300000,81700000,128000000
1533,Sex Tape,Sony,2014,38500000,87500000,126000000
1534,The Theory of Everything,Focus,2014,35900000,87800000,123700000
1535,The Nut Job,ORF,2014,64300000,56600000,120900000
1536,The Wind Rises,BV,2014,5200000,112700000,117900000
1537,Pompeii,TriS,2014,23200000,94600000,117800000
1538,The Admiral: Roaring Currents,CJ,2014,2600000,109600000,112200000
1539,The Purge: Anarchy,Uni.,2014,72000000,40000000,112000000
1540,The Boxtrolls,Focus,2014,50800000,58400000,109200000
1541,Horrible Bosses 2,WB,2014,54400000,53200000,107600000
1542,Ouija,Uni.,2014,50900000,52700000,103600000
1543,Birdman,FoxS,2014,42300000,60900000,103200000
1544,Transcendence,WB,2014,23000000,80000000,103000000
1545,"Alexander and the Terrible, Horrible, No Good, Very Bad Day",BV,2014,67000000,34400000,101400000
1546,Heaven is for Real,TriS,2014,91400000,9900000,101300000
1547,Tammy,WB (NL),2014,84500000,16000000,100500000
1548,P.K.,UTV,2014,10600000,89800000,100400000
1549,The Book of Life (2014),Fox,2014,50200000,49600000,99800000
1550,Paranormal Activity: The Marked Ones,Par.,2014,32500000,58400000,90900000
1551,The Hundred-Foot Journey,BV,2014,54200000,34600000,88800000
1552,John Wick,LG/S,2014,43000000,45700000,88700000
1553,Deliver Us From Evil,SGem,2014,30600000,57400000,88000000
1554,A Million Ways to Die in the West,Uni.,2014,43100000,44100000,87200000
1555,Snowpiercer,RTWC,2014,4600000,82200000,86800000
1556,Step Up All In,LG/S,2014,14900000,71300000,86200000
1557,The Judge,WB,2014,47100000,37300000,84400000
1558,Muppets Most Wanted,BV,2014,51200000,29200000,80400000
1559,If I Stay,WB (NL),2014,50500000,28400000,78900000
1560,"I, Frankenstein",LGF,2014,19100000,52100000,71200000
1561,The Attorney,WGUSA,2014,557000,70000000,70557000
1562,Think Like a Man Too,SGem,2014,65200000,5000000,70200000
1563,Brick Mansions,Rela.,2014,20400000,48500000,68900000
1564,Stalingrad (2014),Sony,2014,1000000,67099999,68099999
1565,Son of God,Fox,2014,59700000,8100000,67800000
1566,Jersey Boys,WB,2014,47000000,20600000,67600000
1567,The Giver,Wein.,2014,45100000,21900000,67000000
1568,Selma,Par.,2014,52100000,14700000,66800000
1569,God's Not Dead,Free,2014,60800000,3900000,64700000
1570,Thunder and the House of Magic!,Shout!,2014,4100,64200000,64204100
1571,Begin Again,Wein.,2014,16200000,47300000,63500000
1572,The Legend of Hercules,LG/S,2014,18800000,42400000,61200000
1573,Evangelion: 3.0 You Can (Not) Redo,Elev.,2014,175000,60300000,60475000
1574,Dolphin Tale 2,WB,2014,42000000,15800000,57800000
1575,St. Vincent,Wein.,2014,44100000,10700000,54800000
1576,No Good Deed (2014),SGem,2014,52500000,1800000,54300000
1577,A Walk Among the Tombstones,Uni.,2014,26300000,26900000,53200000
1578,3 Days to Kill,Rela.,2014,30700000,21900000,52600000
1579,Wild (2014),FoxS,2014,37900000,14600000,52500000
1580,Magic in the Moonlight,SPC,2014,10500000,40500000,51000000
1581,Dragon Ball Z: Battle of Gods,SV,2014,2600000,47800000,50400000
1582,About Last Night (2014),SGem,2014,48600000,365000,48965000
1583,Whiplash,SPC,2014,13100000,35900000,49000000
1584,Chef,ORF,2014,31400000,14500000,45900000
1585,Earth to Echo,Rela.,2014,38900000,6400000,45300000
1586,Boyhood,IFC,2014,25400000,19100000,44500000
1587,Oculus,Rela.,2014,27700000,16300000,44000000
1588,Bang Bang,FIP,2014,2500000,39500000,42000000
1589,As Above/So Below,Uni.,2014,21300000,20600000,41900000
1590,This is Where I Leave You,WB,2014,34300000,7000000,41300000
1591,That Awkward Moment,Focus,2014,26100000,14400000,40500000
1592,Frank Miller's Sin City: A Dame to Kill For,W/Dim.,2014,13800000,25600000,39400000
1593,The Gambler,Par.,2014,33700000,5600000,39300000
1594,Million Dollar Arm,BV,2014,36500000,2800000,39300000
1595,Nightcrawler,ORF,2014,32400000,6300000,38700000
1596,Devil's Due,Fox,2014,15800000,21100000,36900000
1597,A Most Wanted Man,RAtt.,2014,17200000,19000000,36200000
1598,The Best of Me,Rela.,2014,26800000,9200000,36000000
1599,Endless Love (2014),Uni.,2014,23400000,11300000,34700000
1600,Get On Up,Uni.,2014,30700000,2700000,33400000
1601,The November Man,Rela.,2014,25000000,7500000,32500000
1602,The Pirates,WGUSA,2014,416000,32100000,32516000
1603,Winter's Tale,WB,2014,12600000,18500000,31100000
1604,When the Game Stands Tall,TriS,2014,30100000,0,30100000
1605,Draft Day,LG/S,2014,28800000,620000,29420000
1606,Big Eyes,Wein.,2014,14500000,14800000,29300000
1607,The Divine Move,CJ,2014,137000,27800000,27937000
1608,Top Five,Par.,2014,25300000,800000,26100000
1609,Iceman (2014),WGUSA,2014,7700,26000000,26007700
1610,And So It Goes,CE,2014,15200000,10200000,25400000
1611,On the Other Side of the Tracks,Wein.,2014,9600,25100000,25109600
1612,The Players,Wein.,2014,10900,24600000,24610900
1613,The Tale of The Princess Kaguya,GK,2014,703000,23500000,24203000
1614,A Haunted House 2,ORF,2014,17300000,6600000,23900000
1615,The Railway Man,Wein.,2014,4400000,17900000,22300000
1616,Mr. Turner,SPC,2014,4000000,18200000,22200000
1617,The Suspect (2014),WGUSA,2014,219000,21400000,21619000
1618,Bears,BV,2014,17800000,3500000,21300000
1619,Yves Saint Laurent,Wein.,2014,724000,20300000,21024000
1620,Labor Day,Par.,2014,13400000,6900000,20300000
1621,"Like Father, Like Son (2014)",IFC,2014,335000,19600000,19935000
1622,Left Behind (2014),Free,2014,14000000,5700000,19700000
1623,Legends of Oz: Dorothy's Return,CE,2014,8500000,10200000,18700000
1624,The Drop,FoxS,2014,10700000,7900000,18600000
1625,The Quiet Ones,LGF,2014,8500000,9300000,17800000
1626,Sabotage (2014),ORF,2014,10500000,7000000,17500000
1627,Addicted,LGF,2014,17400000,0,17400000
1628,Road to Ninja - Naruto the Movie,Elev.,2014,43200,17300000,17343200
1629,Calvary,FoxS,2014,3600000,13300000,16900000
1630,The Pyramid,Fox,2014,2800000,14100000,16900000
1631,Tyler Perry's The Single Moms Club,LGF,2014,16000000,364000,16364000
1632,Beyond Outrage,Magn.,2014,3900,16200000,16203900
1633,Before I Go To Sleep,CE,2014,3200000,12200000,15400000
1634,Vampire Academy,Wein.,2014,7800000,7600000,15400000
1635,Inherent Vice,WB,2014,8100000,6600000,14700000
1636,Island of Lemurs: Madagascar (IMAX),WB,2014,11300000,2800000,14100000
1637,The Two Faces of January,Magn.,2014,507000,13000000,13507000
1638,Fading Gigolo,MNE,2014,3800000,9600000,13400000
1639,Foxcatcher,SPC,2014,12100000,0,12100000
1640,A Most Violent Year,A24,2014,5700000,6300000,12000000
1641,The Interview (2014),Sony,2014,6100000,5200000,11300000
1642,One Chance,Wein.,2014,101000,10800000,10901000
1643,Bicycling with Moliere,Strand,2014,59900,10700000,10759900
1644,Belle,FoxS,2014,10700000,0,10700000
1645,Wetlands,Strand,2014,59500,10500000,10559500
1646,Moms' Night Out,TriS,2014,10400000,0,10400000
1647,The Babadook,IFC,2014,964000,9300000,10264000
1648,Nymphomaniac: Volume I,Magn.,2014,786000,9500000,10286000
1649,Gladiators of Rome,VPD,2014,8200,10100000,10108200
1650,Mood Indigo,Drft.,2014,303000,9500000,9803000
1651,Alan Partridge: The Movie,Magn.,2014,153000,9600000,9753000
1652,Venus in Fur,IFC,2014,374000,8000000,8374000
1653,Filth,Magn.,2014,34400,8300000,8334400
1654,What If (2014),CBS,2014,3500000,4400000,7900000
1655,Finding Fanny,FIP,2014,616000,7100000,7716000
1656,Pride (2014),CBS,2014,1400000,6100000,7500000
1657,Chinese Puzzle,Cohen,2014,339000,7100000,7439000
1658,A Long Way Down,Magn.,2014,13300,7200000,7213300
1660,"Two Days, One Night",IFC,2014,1400000,5400000,6800000
1661,A Letter to Momo,GK,2014,71700,6700000,6771700
1662,Cantinflas,LGF,2014,6400000,0,6400000
1663,Le Chef,Cohen,2014,343000,5900000,6243000
1664,Mas Negro Que La Noche,LGF,2014,870000,5200000,6070000
1665,French Gigolo (Cliente),IFC,2014,3000,6000000,6003000
1666,The Trip to Italy,IFC,2014,2900000,3000000,5900000
1667,The Immigrant,Wein.,2014,2000000,3800000,5800000
1668,Wish I Was Here,Focus,2014,3600000,1900000,5500000
1669,Under the Skin (2014),A24,2014,2600000,2800000,5400000
1670,The Skeleton Twins,RAtt.,2014,5300000,0,5300000
1671,The French Minister,IFC,2014,12000,5100000,5112000
1672,Ernest & Celestine,GK,2014,262000,4800000,5062000
1673,Tracks (2014),Wein.,2014,510000,4400000,4910000
1674,The Love Punch,KE,2014,267000,4500000,4767000
1675,Dear White People,RAtt.,2014,4400000,0,4400000
1676,The Lunchbox,SPC,2014,4200000,0,4200000
1677,My Old Lady,Cohen,2014,4000000,0,4000000
1678,Diplomacy,Zeit.,2014,231000,3700000,3931000
1679,Horns,RTWC,2014,174000,3700000,3874000
1680,Ida,MBox,2014,3800000,0,3800000
1682,Ragnarok,Magn.,2014,1400,3700000,3701400
1683,Veronica Mars,WB,2014,3300000,195000,3495000
1684,Mommy,RAtt.,2014,3500000,0,3500000
1686,The Grand Seduction,EOne,2014,3400000,0,3400000
1687,Enemy,A24,2014,1000000,2400000,3400000
1688,Words and Pictures,RAtt.,2014,2200000,1200000,3400000
1689,The Protector 2,Magn.,2014,2500,3300000,3302500
1690,The Rover,A24,2014,1100000,2100000,3200000
1691,The Mystery of Happiness,Strand,2014,8500,3200000,3208500
1692,Rosewater,ORF,2014,3100000,0,3100000
1693,Obvious Child,A24,2014,3100000,0,3100000
1694,The German Doctor,Gold.,2014,418000,2600000,3018000
1695,Citizenfour,RTWC,2014,2800000,202000,3002000
1696,A Coffee in Berlin,MBox,2014,150000,2600000,2750000
1697,The Good Lie,WB,2014,2700000,0,2700000
1698,The Raid 2,SPC,2014,2600000,0,2600000
1699,Living is Easy with Eyes Closed,Outs,2014,11600,2600000,2611600
1700,A Five Star Life,MBox,2014,307000,2200000,2507000
1701,Kick,UTV,2014,2500000,0,2500000
1702,Kill the Messenger,Focus,2014,2500000,0,2500000
1703,The Homesman,Saban,2014,2400000,0,2400000
1704,Blood Ties (2014),RAtt.,2014,42500,2400000,2442500
1705,The Guest (2014),PH,2014,333000,2000000,2333000
1706,Life of Riley,KL,2014,11600,2300000,2311600
1707,Ode to My Father,CJ,2014,2300000,0,2300000
1708,Love is Strange,SPC,2014,2300000,0,2300000
1709,Marius,KL,2014,9800,2200000,2209800
1710,"Men, Women & Children",Par.,2014,706000,1500000,2206000
1711,2 States,UTV,2014,2200000,0,2200000
1712,Nymphomaniac: Volume II,Magn.,2014,327000,1900000,2227000
1713,Le Week-End,MBox,2014,2200000,0,2200000
1714,Gloria (2014),RAtt.,2014,2100000,0,2100000
1715,"20,000 Days on Earth",Drft.,2014,280000,1800000,2080000
1716,Only Lovers Left Alive,SPC,2014,1900000,0,1900000
1717,Tusk,A24,2014,1800000,0,1800000
1718,Awake: The Life of Yogananda,CF&SR,2014,1500000,0,1500000
1719,Fed Up,RTWC,2014,1500000,0,1500000
1720,Finding Vivian Maier,IFC,2014,1500000,0,1500000
1721,Make Your Move,HTR,2014,125000,1300000,1425000
1722,Bright Days Ahead,Trib.,2014,21800,1400000,1421800
1723,Locke,A24,2014,1400000,0,1400000
1724,Force Majeure,Magn.,2014,1400000,0,1400000
1725,Postman Pat: The Movie,Shout!,2014,1500,1300000,1301500
1726,Just a Sigh,Distrib.,2014,75500,1200000,1275500
1727,Jai Ho,Eros,2014,1300000,0,1300000
1728,For a Woman,FM,2014,32299,1200000,1232299
1729,Singham Returns,Eros,2014,1200000,0,1200000
1730,Why Don't You Play in Hell,Drft.,2014,28500,1200000,1228500
1731,The Remaining,Triu,2014,1200000,0,1200000
1732,The Way He Looks,Strand,2014,101000,1100000,1201000
1733,Ilo Ilo,FM,2014,56800,1100000,1156800
1734,Hector And The Search For Happiness,Rela.,2014,1100000,0,1100000
1735,Leviathan (2014),SPC,2014,1100000,0,1100000
1736,The Captive,A24,2014,1100000,0,1100000
1737,Laggies,A24,2014,1100000,0,1100000
1738,Jackpot,DR,2014,800,1100000,1100800
1740,Haider,UTV,2014,1000000,0,1000000
1741,Third Person,SPC,2014,1000000,0,1000000
1742,Borgman,Drft.,2014,57500,952000,1009500
1743,The Disappearance of Eleanor Rigby,Wein.,2014,588000,397000,985000
1744,Shaadi Ke Side Effects,Eros,2014,921000,0,921000
1745,Song of the Sea,GK,2014,858000,0,858000
1746,Kochadaiiyaan,Eros,2014,817000,0,817000
1747,Age of Uprising: The Legend of Michael Kohlhaas (U.S. only),MBox,2014,3300,797000,800300
1748,The Zero Theorem,Ampl.,2014,258000,513000,771000
1749,Palo Alto,Trib.,2014,768000,0,768000
1750,Ek Villain,Eros,2014,731000,0,731000
1751,Khoobsurat,UTV,2014,711000,0,711000
1752,Holiday (2014),Relbig.,2014,707000,0,707000
1753,Hasee Toh Phasee,Relbig.,2014,646000,0,646000
1754,Frank,Magn.,2014,645000,0,645000
1755,Mary Kom,Eros,2014,621000,0,621000
1756,The Signal (2014),Focus,2014,601000,0,601000
1757,Back in Time (Congcong Nanian),CL,2014,569000,0,569000
1758,Highway (2014),UTV,2014,529000,0,529000
1759,Dom Hemingway,FoxS,2014,524000,0,524000
1760,The One I Love,RTWC,2014,513000,0,513000
1761,Archipelago,KL,2014,7800,492000,499800
1762,A Girl Walks Home Alone at Night,KL,2014,492000,0,492000
1763,The Congress,Drft.,2014,138000,318000,456000
1764,In Secret,RAtt.,2014,444000,0,444000
1765,Bjork - Biophilia Live,CP,2014,128000,306000,434000
1766,But Always (Yi Sheng Yi Shi),CL,2014,431000,0,431000
1767,Beijing Love Story,CL,2014,428000,0,428000
1768,Goodbye to Language,KL,2014,390000,0,390000
1769,Humpty Sharma Ki Dulhania,Relbig.,2014,380000,0,380000
1770,Women Who Flirt (Sajiao Nvren),CL,2014,375000,0,375000
1771,Joe (2014),RAtt.,2014,373000,0,373000
1772,Omar,AF,2014,356000,0,356000
1773,The Face of Love,IFC,2014,350000,0,350000
1774,Jimi: All Is By My Side,XL,2014,341000,0,341000
1775,I Origins,FoxS,2014,336000,0,336000
1776,The Last Sentence,MBox,2014,62500,265000,327500
1777,On My Way,Cohen,2014,317000,0,317000
1778,Happy Ending,Eros,2014,314000,0,314000
1779,I Am Eleven,Proud,2014,310000,0,310000
1780,7 Boxes,BGP,2014,38100,267000,305100
1781,The Dance of Reality,Abk.,2014,294000,0,294000
1782,Elsa & Fred (2014),MNE,2014,286000,0,286000
1783,Main Tera Hero,Eros,2014,275000,0,275000
1784,Night Moves,Cdgm.,2014,272000,0,272000
1785,Love on the Cloud (Wei Ai),CL,2014,272000,0,272000
1786,Life of Crime,RAtt.,2014,265000,0,265000
1787,The Green Prince,MBox,2014,258000,0,258000
1788,Action Jackson (2014),Eros,2014,257000,0,257000
1789,The Blue Room,IFC,2014,255000,0,255000
1790,Tazza: The Hidden Card,CJ,2014,252000,0,252000
1791,James Cameron's Deepsea Challenge 3D,DLA,2014,236000,0,236000
1792,Gabrielle (2014),EOne,2014,5500,222000,227500
1793,The Breakup Guru,CL,2014,209000,0,209000
1794,Bethlehem,AF,2014,202000,0,202000
1795,The Double (2014),Magn.,2014,200000,0,200000
1796,Listen Up Philip,Trib.,2014,200000,0,200000
1797,We Are The Best!,Magn.,2014,181000,0,181000
1798,That Demon Within,CL,2014,172000,0,172000
1799,God's Pocket,IFC,2014,170000,0,170000
1800,Unrelated,KL,2014,4500,154000,158500
1801,The Polar Express (2014 re-issue),WB,2014,139000,0,139000
1802,May in the Summer,Cohen,2014,22000,112000,134000
1803,The Jewish Cardinal,FM,2014,134000,0,134000
1804,Zero Motivation,Zeit.,2014,116000,0,116000
1805,Life's a Breeze,Magn.,2014,3500,99700,103200
1806,The Golden Era,CL,2014,103000,0,103000
1807,God Help the Girl,Ampl.,2014,103000,0,103000
1808,The Best Offer,IFC,2014,100000,0,100000
1809,Child's Pose,Zeit.,2014,97200,0,97200
1810,Cuban Fury,EOne,2014,92400,0,92400
1811,Girl on a Bicycle,Mont.,2014,91400,0,91400
1812,Breathe In,Cohen,2014,89700,0,89700
1813,Life After Beth,A24,2014,88300,0,88300
1814,Advanced Style,B360,2014,87900,0,87900
1815,Better Living Through Chemistry,Gold.,2014,75100,0,75100
1816,For No Good Reason,SPC,2014,67400,0,67400
1817,The Notebook (2014),SPC,2014,66600,0,66600
1818,Heropanti,UTV,2014,63600,0,63600
1819,No Tears for the Dead,CJ,2014,63100,0,63100
1820,Young and Beautiful,IFC,2014,61100,0,61100
1821,Siddharth,Zeit.,2014,60500,0,60500
1822,Walk of Shame,FCW,2014,59200,0,59200
1823,The Conformist (2014 re-release),KL,2014,58700,0,58700
1824,Rudderless,Gold.,2014,58300,0,58300
1825,The Rocket (2014),KL,2014,56800,0,56800
1826,In Bloom,BWP,2014,56100,0,56100
1827,Starred Up,Trib.,2014,54900,0,54900
1828,Half of a Yellow Sun,Mont.,2014,54500,0,54500
1829,Hateship Loveship,IFC,2014,54000,0,54000
1830,"1,000 Times Good Night",FM,2014,53900,0,53900
1831,The Missing Picture,Strand,2014,52200,0,52200
1832,Decoding Annie Parker,EOne,2014,48400,0,48400
1833,Alphaville (2013 re-release),Rialto,2014,47700,0,47700
1834,Return to The Hiding Place,SEA,2014,45400,0,45400
1835,Policeman,Crnth,2014,11300,27000,38300
1836,White Bird in a Blizzard,Magn.,2014,33800,0,33800
1837,The Hero of Color City,Magn.,2014,32200,0,32200
1838,Bird People,IFC,2014,32100,0,32100
1839,Closed Curtain,Vari.,2014,28100,0,28100
1840,Lilting,Strand,2014,27100,0,27100
1841,Adult World,IFC,2014,25400,0,25400
1842,A Tale of Winter (Conte d'hiver),BWP,2014,23300,0,23300
1843,The Decent One,KL,2014,21300,0,21300
1844,Guardian Angel,RME,2014,19500,0,19500
1845,Tasting Menu,Magn.,2014,18700,0,18700
1846,Two Night Stand,EOne,2014,18600,0,18600
1847,Burning Bush,KL,2014,16700,0,16700
1848,Horses of God,KL,2014,14800,0,14800
1849,13 Sins,RTWC,2014,13800,0,13800
1850,Camp X-Ray,IFC,2014,13300,0,13300
1851,Special ID,WGUSA,2014,12700,0,12700
1852,Wolves,KE,2014,12100,0,12100
1853,Falcon Rising,Free,2014,11800,0,11800
1854,You're Not You,EOne,2014,11500,0,11500
1855,The Amazing Catfish,Strand,2014,11300,0,11300
1856,Stray Dogs,CGld,2014,10400,0,10400
1857,Canopy,Mont.,2014,8500,0,8500
1858,Love is in the Air,FCW,2014,8400,0,8400
1859,Empty Hours,Strand,2014,8200,0,8200
1860,Rigor Mortis,WGUSA,2014,7900,0,7900
1861,The Little Bedroom,CLS,2014,7400,0,7400
1862,Plot for Peace,,2014,7100,0,7100
1863,Very Good Girls,WGUSA,2014,6900,0,6900
1864,Pioneer,Magn.,2014,6900,0,6900
1865,Life of a King,MNE,2014,6500,0,6500
1866,The Strange Little Cat,KS,2014,5900,0,5900
1867,"2 Autumns, 3 Winters",FM,2014,5800,0,5800
1868,The Devil's Hand,RAtt.,2014,5700,0,5700
1869,Anna,VE,2014,4300,0,4300
1870,Open Windows,Cdgm.,2014,1800,0,1800
1871,Mr. Pip,Free,2014,1700,0,1700
1872,Star Wars: The Force Awakens,BV,2015,936700000,1131,936701131
1873,Jurassic World,Uni.,2015,652300000,1019,652301019
1874,Furious 7,Uni.,2015,353000000,1163,353001163
1875,Avengers: Age of Ultron,BV,2015,459000000,946400000,1405400000
1876,Minions,Uni.,2015,336000000,823400000,1159400000
1877,Spectre,Sony,2015,200100000,680600000,880700000
1878,Inside Out,BV,2015,356500000,501100000,857600000
1879,Mission: Impossible - Rogue Nation,Par.,2015,195000000,487700000,682700000
1880,The Hunger Games: Mockingjay - Part 2,LGF,2015,281700000,371700000,653400000
1881,The Martian,Fox,2015,228400000,401700000,630100000
1882,Fifty Shades of Grey,Uni.,2015,166200000,404800000,571000000
1883,Cinderella (2015),BV,2015,201200000,342400000,543600000
1884,The Revenant,Fox,2015,183600000,349300000,532900000
1885,Ant-Man,BV,2015,180200000,339100000,519300000
1886,Hotel Transylvania 2,Sony,2015,169700000,305100000,474800000
1887,San Andreas,WB (NL),2015,155200000,318800000,474000000
1888,Terminator: Genisys,Par.,2015,89800000,350800000,440600000
1889,Kingsman: The Secret Service,Fox,2015,128300000,286100000,414400000
1890,Home (2015),Fox,2015,177400000,208600000,386000000
1891,Mad Max: Fury Road,WB,2015,153600000,224800000,378400000
1892,The Good Dinosaur,BV,2015,123100000,209100000,332200000
1893,Taken 3,Fox,2015,89300000,237200000,326500000
1894,The SpongeBob Movie: Sponge Out of Water,Par.,2015,163000000,162200000,325200000
1895,Maze Runner: The Scorch Trials,Fox,2015,81700000,230600000,312300000
1896,The Divergent Series: Insurgent,LG/S,2015,130199999,167100000,297299999
1897,Pitch Perfect 2,Uni.,2015,184300000,103200000,287500000
1898,Paddington,W/Dim.,2015,76300000,191800000,268100000
1899,Mojin: The Lost Legend,WGUSA,2015,1200000,258100000,259300000
1900,Lost in Hong Kong,WGUSA,2015,1300000,255000000,256300000
1901,The Peanuts Movie,Fox,2015,130199999,116100000,246299999
1902,Pixels,Sony,2015,78700000,166100000,244800000
1903,Daddy's Home,Par.,2015,150400000,92400000,242800000
1904,Spy,Fox,2015,110800000,124800000,235600000
1905,Alvin and the Chipmunks: The Road Chip,Fox,2015,85900000,148900000,234800000
1906,Goodbye Mr. Loser,CL,2015,1300000,226800000,228100000
1907,Ted 2,Uni.,2015,81500000,135200000,216700000
1908,Tomorrowland,BV,2015,93400000,115700000,209100000
1909,Everest (2015),Uni.,2015,43500000,159900000,203400000
1910,Straight Outta Compton,Uni.,2015,161200000,40400000,201600000
1911,The Intern,WB,2015,75800000,118800000,194600000
1912,Jupiter Ascending,WB,2015,47400000,136600000,184000000
1913,Creed,WB (NL),2015,109800000,63800000,173600000
1914,Fantastic Four,Fox,2015,56100000,111900000,168000000
1915,Bridge of Spies,BV,2015,72300000,93200000,165500000
1916,Focus (2015),WB,2015,53900000,105200000,159100000
1917,The Hateful Eight,Wein.,2015,54100000,101600000,155700000
1918,Goosebumps,Sony,2015,80100000,70100000,150200000
1919,The Last Witch Hunter,LG/S,2015,27400000,119600000,147000000
1920,The Taking of Tiger Mountain,WGUSA,2015,229000,141400000,141629000
1921,Trainwreck,Uni.,2015,110200000,30600000,140800000
1922,Mr. Six,CL,2015,1400000,137800000,139200000
1923,Point Break (2015),WB,2015,28800000,104900000,133700000
1924,The Big Short,Par.,2015,70300000,63200000,133500000
1925,Pan,WB,2015,35100000,93300000,128400000
1926,Wolf Totem,Sony,2015,211000,125600000,125811000
1927,Magic Mike XXL,WB,2015,66000000,56500000,122500000
1928,Dragon Blade,LGP,2015,74100,121500000,121574100
1929,Seventh Son,Uni.,2015,17200000,97000000,114200000
1930,Insidious Chapter 3,Focus,2015,52200000,60800000,113000000
1931,Get Hard,WB,2015,90400000,21400000,111800000
1932,The Man From U.N.C.L.E.,WB,2015,45400000,64400000,109800000
1933,Paul Blart: Mall Cop 2,Sony,2015,71000000,36600000,107600000
1934,Shaun the Sheep Movie,LGF,2015,19400000,86800000,106200000
1935,Sisters,Uni.,2015,87000000,18000000,105000000
1936,Vacation,WB (NL),2015,58900000,46000000,104900000
1937,Chappie,Sony,2015,31600000,70500000,102100000
1938,Joy,Fox,2015,56500000,44700000,101200000
1939,Black Mass,WB,2015,62600000,37200000,99800000
1940,Devil and Angel (E Gun Tian Shi),CL,2015,131000,98500000,98631000
1941,The Visit,Uni.,2015,65200000,33200000,98400000
1942,Spotlight,ORF,2015,45100000,53200000,98300000
1943,Poltergeist (2015),Fox,2015,47400000,48000000,95400000
1944,In the Heart of the Sea,WB,2015,25000000,68900000,93900000
1945,Southpaw,Wein.,2015,52400000,39500000,91900000
1946,The Second Best Exotic Marigold Hotel,FoxS,2015,33100000,52900000,86000000
1947,Paper Towns,Fox,2015,32000000,53500000,85500000
1948,Sicario,LGF,2015,46900000,38000000,84900000
1949,Hitman: Agent 47,Fox,2015,22500000,59900000,82400000
1950,The Wedding Ringer,SGem,2015,64500000,15300000,79800000
1951,Paranormal Activity: The Ghost Dimension,Par.,2015,18300000,60600000,78900000
1952,Crimson Peak,Uni.,2015,31100000,43600000,74700000
1953,The Transporter Refueled,EC,2015,16000000,56600000,72600000
1954,Run All Night,WB,2015,26500000,45200000,71700000
1955,War Room,TriS,2015,67800000,0,67800000
1956,The Age of Adaline,LGF,2015,42600000,23000000,65600000
1957,The Danish Girl,Focus,2015,11100000,53100000,64200000
1958,Unfriended,Uni.,2015,32500000,31600000,64100000
1959,The Longest Ride,Fox,2015,37400000,25500000,62900000
1960,Brooklyn,FoxS,2015,38300000,23800000,62100000
1961,Dragon Ball Z: Resurrection 'F',FUN,2015,8000000,53800000,61800000
1962,Woman in Gold,Wein.,2015,33299999,28300000,61599999
1963,Krampus,Uni.,2015,42700000,18800000,61500000
1964,The Walk,TriS,2015,10100000,51000000,61100000
1965,The Perfect Guy,SGem,2015,57000000,3200000,60200000
1966,The Gift (2015),STX,2015,43800000,15200000,59000000
1967,No Escape,Wein.,2015,27300000,27100000,54400000
1968,Sinister 2,Focus,2015,27700000,25100000,52800000
1969,Prem Ratan Dhan Payo,FIP,2015,4400000,48200000,52600000
1970,The Boy Next Door,Uni.,2015,35400000,17000000,52400000
1971,The Night Before,Sony,2015,43000000,9300000,52300000
1972,Hot Pursuit,WB (NL),2015,34600000,17100000,51700000
1973,The 100-Year Old Man Who Climbed Out the Window and Disappeared,MBox,2015,944000,50200000,51144000
1974,The Himalayas,CJ,2015,697000,49800000,50497000
1976,Entourage,WB,2015,32400000,16900000,49300000
1977,The Woman in Black 2: Angel of Death,Rela.,2015,26500000,22400000,48900000
1978,Concussion (2015),Sony,2015,34500000,14100000,48600000
1979,Mortdecai,LGF,2015,7700000,39600000,47300000
1980,Coming Home (2015),SPC,2015,378000,46400000,46778000
1981,"McFarland, USA",BV,2015,44500000,1200000,45700000
1982,Max (2015),WB,2015,42700000,1300000,44000000
1983,Still Alice,SPC,2015,18800000,25100000,43900000
1984,The DUFF,LGF,2015,34000000,9500000,43500000
1985,Legend,Uni.,2015,1900000,41100000,43000000
1986,The Gallows,WB (NL),2015,22800000,20200000,43000000
1987,Love the Coopers,LGF,2015,26300000,16100000,42400000
1988,The Lady in the Van,SPC,2015,10000000,31400000,41400000
1989,Ricki and the Flash,TriS,2015,26800000,14500000,41300000
1990,Carol,Wein.,2015,12700000,27600000,40300000
1991,The Lazarus Effect,Rela.,2015,25800000,12600000,38400000
1992,The Water Diviner,WB,2015,4200000,34000000,38200000
1993,A Walk in the Woods,BG,2015,29500000,8000000,37500000
1994,Ex Machina,A24,2015,25400000,11400000,36800000
1995,Burnt,Wein.,2015,13700000,23000000,36700000
1996,Room,A24,2015,14700000,20700000,35400000
1997,The Secret in their Eyes (2015),STX,2015,20200000,14700000,34900000
1998,Steve Jobs,Uni.,2015,17800000,16700000,34500000
1999,Victor Frankenstein,Fox,2015,5800000,28500000,34300000
2000,Project Almanac,Par.,2015,22300000,10900000,33200000
2001,Self/Less,Focus,2015,12300000,18200000,30500000
2002,Far from the Madding Crowd,FoxS,2015,12200000,18000000,30200000
2003,Mr. Holmes,RAtt.,2015,17700000,11600000,29300000
2004,Love & Mercy,RAtt.,2015,12600000,16100000,28700000
2005,Irrational Man,SPC,2015,4000000,23400000,27400000
2006,American Ultra,LGF,2015,14400000,12700000,27100000
2007,Wild Tales,SPC,2015,3100000,23900000,27000000
2008,Aloha,Sony,2015,21100000,5200000,26300000
2009,"Love, Rosie",TFA,2015,20400,25600000,25620400
2010,The 33,WB,2015,12200000,12700000,24900000
2011,Capture the Flag,Par.,2015,6700,24600000,24606700
2012,The Gunman,ORF,2015,10700000,13500000,24200000
2013,Go Away Mr. Tumor,CL,2015,287000,21500000,21787000
2014,Black or White,Rela.,2015,21600000,0,21600000
2015,Blackhat,Uni.,2015,8000000,11600000,19600000
2016,Dope,ORF,2015,17500000,480000,17980000
2017,Brothers: Blood Against Blood,FIP,2015,614000,17200000,17814000
2018,While We're Young,A24,2015,7600000,9700000,17300000
2019,Monkey Kingdom,BV,2015,16399999,711000,17110999
2020,Macbeth (2015),Wein.,2015,1100000,15200000,16300000
2021,Scouts Guide to the Zombie Apocalypse,Par.,2015,3700000,12400000,16100000
2022,Suffragette,Focus,2015,4700000,11300000,16000000
2023,It Follows,RTWC,2015,14700000,0,14700000
2024,Unfinished Business,Fox,2015,10200000,4200000,14400000
2025,Do You Believe?,PFR,2015,13000000,1400000,14400000
2026,Woodlawn,PFR,2015,14400000,0,14400000
2027,Strange Magic,BV,2015,12400000,1200000,13600000
2028,Hot Tub Time Machine 2,Par.,2015,12300000,767000,13067000
2029,Child 44,LG/S,2015,1200000,11700000,12900000
2030,We Are Your Friends,WB,2015,3600000,7500000,11100000
2031,Danny Collins,BST,2015,5600000,5200000,10800000
2032,Kung Fu Killer,WGUSA,2015,130000,10000000,10130000
2033,A Little Chaos,FCW,2015,558000,9500000,10058000
2034,The Loft,ORF,2015,6000000,4099999,10099999
2035,The Young & Prodigious T.S. Spivet,Wein.,2015,174000,9300000,9474000
2036,Shanghai,Wein.,2015,46400,9200000,9246400
2037,Un Gallo con Muchos Huevos,LGF,2015,9100000,0,9100000
2038,Me and Earl and the Dying Girl,FoxS,2015,6800000,2300000,9100000
2039,Amy,A24,2015,8400000,0,8400000
2040,Shaandaar,FIP,2015,522000,7800000,8322000
2041,Trumbo (2015),BST,2015,7900000,378000,8278000
2042,Bajrangi Bhaijaan,Eros,2015,8199999,0,8199999
2043,I'll See You In My Dreams,BST,2015,7400000,0,7400000
2044,The Green Inferno,BH Tilt,2015,7200000,0,7200000
2045,Grandma (2015),SPC,2015,7000000,107000,7107000
2046,Our Brand Is Crisis (2015),WB,2015,7000000,0,7000000
2047,Baahubali: The Beginning,BSC,2015,6700000,0,6700000
2048,Bajirao Mastani,Eros,2015,6600000,0,6600000
2049,Little Boy,ORF,2015,6500000,0,6500000
2050,What We Do in the Shadows,U/P,2015,3500000,2800000,6300000
2051,Anomalisa,Par.,2015,3800000,1900000,5700000
2052,Pawn Sacrifice,BST,2015,2400000,3100000,5500000
2053,Serena,Magn.,2015,176000,4900000,5076000
2054,Mr. X,FIP,2015,45000,5000000,5045000
2055,Dilwale,UTV,2015,4900000,0,4900000
2056,Back to the Future Day,UHE,2015,1700000,3200000,4900000
2057,Trash,FCW,2015,17500,4800000,4817500
2058,True Story,FoxS,2015,4700000,0,4700000
2059,"Buen Dia, Ramon",FIP,2015,154000,4500000,4654000
2060,Hamari Adhuri Kahani,FIP,2015,235000,4200000,4435000
2061,45 Years,IFC,2015,4200000,0,4200000
2062,Escobar: Paradise Lost,RTWC,2015,196000,3600000,3796000
2063,Spare Parts,LGF,2015,3600000,0,3600000
2064,Learning to Drive,BG,2015,3400000,0,3400000
2065,By the Sea,Uni.,2015,538000,2800000,3338000
2066,Sleeping with Other People,IFC,2015,819000,2400000,3219000
2067,Phoenix (2015),IFC,2015,3200000,0,3200000
2068,Jimmy's Hall,SPC,2015,561000,2600000,3161000
2069,Dil Dhadakne Do,Eros,2015,3100000,0,3100000
2070,Ladrones,LGF,2015,3100000,0,3100000
2071,Remember (Canada Release),EOne,2015,547000,2500000,3047000
2072,Tanu Weds Manu Returns,Eros,2015,3000000,0,3000000
2073,Rock The Kasbah,ORF,2015,3000000,0,3000000
2074,The End of the Tour,A24,2015,3000000,0,3000000
2075,Captive (2015),Par.,2015,2600000,218000,2818000
2076,He Named Me Malala,FoxS,2015,2700000,97100,2797100
2077,Youth,FoxS,2015,2700000,0,2700000
2078,Chi-Raq,RAtt.,2015,2700000,0,2700000
2079,Truth,SPC,2015,2500000,0,2500000
2080,Mistress America,FoxS,2015,2500000,0,2500000
2081,Jem and the Holograms,Uni.,2015,2200000,149000,2349000
2082,Beloved Sisters,MBox,2015,54000,2200000,2254000
2083,The Riot Club,IFC,2015,7700,2100000,2107700
2084,Tamasha,UTV,2015,2100000,0,2100000
2085,Cake,CLF,2015,2000000,0,2000000
2086,Assassination (2015),WGUSA,2015,1900000,0,1900000
2087,Clouds of Sils Maria,IFC,2015,1900000,0,1900000
2088,Testament of Youth,SPC,2015,1800000,0,1800000
2089,Piku,Yash,2015,1800000,0,1800000
2090,The Vatican Tapes,LGF,2015,1800000,0,1800000
2091,Son of Saul,SPC,2015,1800000,0,1800000
2092,Janis: Little Girl Blue,FR,2015,410000,1200000,1610000
2093,'71,RAtt.,2015,1300000,355000,1655000
2094,The Diary of a Teenage Girl,SPC,2015,1500000,0,1500000
2095,I (2015),AaF,2015,1400000,0,1400000
2096,Infinitely Polar Bear,SPC,2015,1400000,0,1400000
2097,99 Homes,BG,2015,1400000,0,1400000
2098,Welcome Back,Eros,2015,1400000,0,1400000
2099,The Salt of the Earth,SPC,2015,1300000,0,1300000
2100,Maps to the Stars,FCW,2015,351000,988000,1339000
2101,Iris (2015),Magn.,2015,1300000,0,1300000
2102,The Wolfpack,Magn.,2015,1300000,0,1300000
2103,Veteran,CJ,2015,1200000,0,1200000
2104,Goodnight Mommy,RTWC,2015,1200000,0,1200000
2105,Black Sea,Focus,2015,1200000,0,1200000
2106,Miss You Already,RAtt.,2015,1200000,0,1200000
2107,Where Hope Grows,RAtt.,2015,1200000,0,1200000
2108,Cartel Land,Orch.,2015,704000,422000,1126000
2109,Timbuktu,Cohen,2015,1100000,0,1100000
2110,Dior and I,Orch.,2015,1000000,0,1000000
2111,5 Flights Up,FCW,2015,1000000,0,1000000
2112,Big Stone Gap,PH,2015,1000000,0,1000000
2113,Gett: The Trial of Viviane Amsalem,MBox,2015,988000,0,988000
2114,Boruto: Naruto the Movie,Elev.,2015,920000,0,920000
2115,Singh is Bling,Eros,2015,919000,0,919000
2116,ABCD (Any Body Can Dance) 2,UTV,2015,892000,0,892000
2117,Mustang,Cohen,2015,845000,0,845000
2118,Labyrinth of Lies,SPC,2015,794000,0,794000
2119,The D Train,IFC,2015,673000,102000,775000
2120,Seymour: An Introduction,IFC,2015,744000,0,744000
2121,Tangerine,Magn.,2015,702000,0,702000
2122,Red Army,SPC,2015,695000,0,695000
2123,The Stanford Prison Experiment,IFC,2015,661000,0,661000
2124,The Assassin,WGUSA,2015,633000,0,633000
2125,"Kumiko, The Treasure Hunter",Ampl.,2015,623000,0,623000
2126,Welcome to Me,Alc,2015,609000,0,609000
2127,Black Panthers: Vanguard of the Revolution,PBS,2015,517000,67200,584200
2128,Detective Byomkesh Bakshy,Yash,2015,579000,0,579000
2129,Freeheld,LGF,2015,573000,0,573000
2130,When Marnie Was There,GK,2015,561000,0,561000
2131,Gabbar is Back,Eros,2015,535000,0,535000
2132,The Last - Naruto the Movie,Elev.,2015,524000,0,524000
2133,Peggy Guggenheim Art Addict,SD,2015,498000,0,498000
2134,Phantom (2015),UTV,2015,490000,0,490000
2135,Somewhere Only We Know,CL,2015,482000,0,482000
2136,Let's Get Married,CL,2015,463000,0,463000
2137,Bombay Velvet,FIP,2015,451000,0,451000
2138,Attack on Titan: Part 1,FUN,2015,450000,0,450000
2139,The Third Man (2015 re-release),Rialto,2015,449000,0,449000
2140,Saint Laurent,SPC,2015,429000,0,429000
2141,Listen to Me Marlon,SHO,2015,426000,0,426000
2142,Heart of a Dog,Abr.,2015,421000,0,421000
2143,The Witness (Wo shi zheng ren),CL,2015,418000,0,418000
2144,Unbranded,Grav.,2015,410000,0,410000
2145,The Second Mother,Osci.,2015,377000,0,377000
2146,Kahlil Gibran's The Prophet (Gathr),Gathr,2015,370000,0,370000
2147,Katti Batti,UTV,2015,365000,0,365000
2148,Kahlil Gibran's The Prophet,GK,2015,355000,0,355000
2149,Effie Gray,AF,2015,353000,0,353000
2150,Noble,Asp.,2015,347000,0,347000
2151,Northern Limit Line,WGUSA,2015,338000,0,338000
2152,Shamitabh,Eros,2015,325000,0,325000
2153,Jafar Panahi's Taxi,KL,2015,322000,0,322000
2154,Good Kill,IFC,2015,316000,0,316000
2155,Running Man (2015),CL,2015,311000,0,311000
2156,Attack on Titan: Part 2,FUN,2015,306000,0,306000
2157,Theeb,FM,2015,283000,0,283000
2158,White God,Magn.,2015,282000,0,282000
2159,A Borrowed Identity,Strand,2015,282000,0,282000
2160,In the Name of my Daughter,Cohen,2015,278000,0,278000
2161,Hitchcock/Truffaut,Cohen,2015,260000,0,260000
2162,Love (2015),Alc,2015,249000,0,249000
2163,Tevar,Eros,2015,236000,0,236000
2164,20 Once Again,CJ,2015,235000,0,235000
2165,Slow West,A24,2015,229000,0,229000
2166,A Royal Night Out,ADC,2015,228000,0,228000
2167,A Pigeon Sat on a Branch Reflecting on Existence,Magn.,2015,223000,0,223000
2168,Pyaar Ka Punchnama 2,Rel.,2015,223000,0,223000
2169,Fall in Love Like a Star,CL,2015,213000,0,213000
2170,Dark Places,A24,2015,209000,0,209000
2171,Heneral Luna,Abr.,2015,206000,0,206000
2172,Gemma Bovery,MBox,2015,192000,0,192000
2173,The Connection,Drft.,2015,191000,0,191000
2174,Love and Lost (Shi Gu),CL,2015,189000,0,189000
2175,Stonewall (2015),RAtt.,2015,188000,0,188000
2176,Maggie,RAtt.,2015,187000,0,187000
2177,Detective K: Secret of the Lost Island,CJ,2015,185000,0,185000
2178,The Priests,CJ,2015,185000,0,185000
2179,The Farewell Party,Gold.,2015,173000,0,173000
2180,A Brilliant Young Mind,Gold.,2015,172000,0,172000
2181,Time Out of Mind,IFC,2015,167000,0,167000
2182,Snow Girl and the Dark Crystal,WGUSA,2015,165000,0,165000
2183,C'Est Si Bon,CJ,2015,164000,0,164000
2184,The Last Women Standing,CL,2015,163000,0,163000
2185,5 to 7,IFC,2015,163000,0,163000
2186,After The Ball,Free,2015,162000,0,162000
2187,Human Capital,FM,2015,159000,0,159000
2188,Experimenter,Magn.,2015,156000,0,156000
2189,Desert Dancer,Rela.,2015,155000,0,155000
2190,Samba,BG,2015,152000,0,152000
2191,The Tribe,Drft.,2015,151000,0,151000
2192,Forever Young (2015),CL,2015,150000,0,150000
2193,The New Girlfriend,Cohen,2015,147000,0,147000
2194,Tangerines,Gold.,2015,145000,0,145000
2195,Manglehorn,IFC,2015,143000,0,143000
2196,Ingrid Bergman: In Her Own Words,Rialto,2015,138000,0,138000
2197,Twenty (2015),CJ,2015,136000,0,136000
2198,La Sapienza,KL,2015,135000,0,135000
2199,Mississippi Grind,A24,2015,131000,0,131000
2200,A Journey Through Time with Anthony,CL,2015,127000,0,127000
2201,Boulevard,SM,2015,126000,0,126000
2202,Z for Zachariah,RAtt.,2015,121000,0,121000
2203,Do I Sound Gay?,IFC,2015,119000,0,119000
2204,Love Live! The School Idol Movie,AZ,2015,116000,0,116000
2205,She's Funny That Way,LGP,2015,112000,0,112000
2206,Memories of the Sword,WGUSA,2015,111000,0,111000
2207,The Look of Silence,Drft.,2015,109000,0,109000
2208,The Beauty Inside,WGUSA,2015,108000,0,108000
2209,The Chronicles of Evil,CJ,2015,105000,0,105000
2210,Every Secret Thing,SM,2015,104000,0,104000
2211,Ghost in the Shell: The New Movie,FUN,2015,101000,0,101000
2212,Black Souls (Anime Nere),Alc,2015,101000,0,101000
2213,A Poem Is a Naked Person (2015 re-issue),Jan.,2015,96600,0,96600
2214,Saving Mr. Wu,UEP,2015,92700,0,92700
2215,The Tales of Hoffmann (2015 re-issue),Rialto,2015,91900,0,91900
2216,Christmas Eve,Ampl.,2015,91300,0,91300
2217,Queen of Earth,IFC,2015,91200,0,91200
2218,Hero (2015),Eros,2015,88700,0,88700
2219,Sunshine Superman,Magn.,2015,88100,0,88100
2220,Heaven Knows What,RTWC,2015,80700,0,80700
2221,Nasty Baby,Orch.,2015,79800,0,79800
2222,The Wonders,Osci.,2015,73400,0,73400
2223,Predestination,VE,2015,68400,0,68400
2224,People Places Things,TFA,2015,67000,0,67000
2225,Eden,BG,2015,65500,0,65500
2226,The Duke of Burgundy,IFC,2015,64500,0,64500
2227,The Office,CL,2015,63700,0,63700
2228,Flowers,MBox,2015,61600,0,61600
2229,Only You,CL,2015,61600,0,61600
2230,Girlhood (2015),Strand,2015,60800,0,60800
2231,Jauja,CGld,2015,60200,0,60200
2232,Gueros,KL,2015,60100,0,60100
2233,I Smile Back,BG,2015,58700,0,58700
2234,The Ark of Mr. Chow,CL,2015,54100,0,54100
2235,Love Thy Nature,ITL,2015,41100,11800,52900
2236,The Advocate: A Missing Body,CJ,2015,50200,0,50200
2237,Heist (2015),LGP,2015,50100,0,50100
2238,Difret,TA,2015,49700,0,49700
2239,Appropriate Behavior,Grav.,2015,46900,0,46900
2240,Beyond the Reach,RAtt.,2015,45900,0,45900
2241,The Salvation,IFC,2015,44900,0,44900
2242,Madame Bovary,Alc,2015,44200,0,44200
2243,Charlie's Country,MR,2015,42900,0,42900
2244,Pearl Button,KL,2015,42200,0,42200
2245,Queen and Country,BBC,2015,41300,0,41300
2246,The Phone,CJ,2015,40500,0,40500
2247,What Our Fathers Did: A Nazi Legacy,Osci.,2015,40100,0,40100
2248,Lila & Eve,Gold.,2015,38300,0,38300
2249,Before We Go,RTWC,2015,37200,0,37200
2250,The Mafia Only Kills in Summer,Distrib.,2015,37100,0,37100
2251,Knock Knock,LGP,2015,36300,0,36300
2252,Kindergarten Teacher,KL,2015,36200,0,36200
2253,Welcome to Leith,FRun,2015,36000,0,36000
2254,Wild City,WGUSA,2015,34900,0,34900
2255,The Forbidden Room,KL,2015,34400,0,34400
2256,Song One,TFA,2015,32299,0,32299
2257,Love Forecast,CJ,2015,32200,0,32200
2258,"Out 1, noli me tangere",CFilms,2015,31500,0,31500
2259,"3 1/2 Minutes, 10 Bullets",Part.,2015,30400,0,30400
2260,Paulette,Cohen,2015,29500,0,29500
2261,The Cut,Strand,2015,28100,0,28100
2262,The Keeping Room,Drft.,2015,27200,0,27200
2263,Big Game,EC,2015,24600,0,24600
2264,Kill Me Three Times,Magn.,2015,24300,0,24300
2265,"Hippocrates, Diary of a French Doctor",Distrib.,2015,23100,0,23100
2266,Court,Zeit.,2015,22900,0,22900
2267,Salut D'Amour,CJ,2015,22500,0,22500
2268,Mediterranea,IFC,2015,22100,0,22100
2269,Noma - My Perfect Storm,Magn.,2015,21100,0,21100
2270,The Little Death,Magn.,2015,18200,0,18200
2271,Gangnam 1970,CJ,2015,18000,0,18000
2272,Strangerland,Alc,2015,17500,0,17500
2273,Eastern Boys,FRun,2015,16800,0,16800
2274,Extraction,LGP,2015,16800,0,16800
2275,Eva,Wein.,2015,16700,0,16700
2276,The World of Kanako,Drft.,2015,16600,0,16600
2277,Zombeavers,Free,2015,14900,0,14900
2278,The Hallow,IFC,2015,13900,0,13900
2279,Amour Fou,FM,2015,13700,0,13700
2280,Arabian Nights: Volume 1 - The Restless One,KL,2015,12300,0,12300
2281,Of Horses and Men,MBox,2015,11900,0,11900
2282,Marie's Story,FM,2015,11700,0,11700
2283,1001 Grams,KL,2015,11000,0,11000
2284,Empire of Lust,CJ,2015,10700,0,10700
2285,The Forecaster,FOR,2015,10200,0,10200
2286,Still Life (2015),Trib.,2015,9500,0,9500
2287,Every Thing Will be Fine,IFC,2015,9200,0,9200
2288,The Lesson,FM,2015,9000,0,9000
2289,An Eye for Beauty,MR,2015,9000,0,9000
2290,Northern Soul,Free,2015,8900,0,8900
2291,The Girl in the Book,Free,2015,8200,0,8200
2292,Steak (R)evolution,KL,2015,8000,0,8000
2293,On the Way to School,Distrib.,2015,7400,0,7400
2294,Hungry Hearts,IFC,2015,6900,0,6900
2295,Steve McQueen: The Man & Le Mans,FR,2015,6800,0,6800
2296,Arabian Nights: Volume 2 - The Desolate One,KL,2015,6400,0,6400
2297,Alleluia,MBox,2015,6300,0,6300
2298,Barely Lethal,A24,2015,6100,0,6100
2299,Chic!,Distrib.,2015,5600,0,5600
2300,Far from Men,Trib.,2015,5300,0,5300
2301,The Dead Lands,Magn.,2015,5200,0,5200
2302,Jenny's Wedding,IFC,2015,4700,0,4700
2303,Against the Sun,TAFC,2015,4600,0,4600
2304,Ashby,TFA,2015,4600,0,4600
2305,Arabian Nights: Volume 3 - The Enchanted One,KL,2015,4500,0,4500
2306,The Summer of Sangaile,Strand,2015,4500,0,4500
2307,Club Life,Orch.,2015,4400,0,4400
2308,Back to the Jurassic,CJ,2015,4400,0,4400
2309,In the Basement,Strand,2015,3600,0,3600
2310,Fidelio: Alice's Odyssey,FRun,2015,3600,0,3600
2311,That Sugar Film,Gold.,2015,3500,0,3500
2312,Xenia,Strand,2015,3200,0,3200
2313,The Iron Ministry,Icar.,2015,3200,0,3200
2314,The Lady in the Car with Glasses and a Gun,Magn.,2015,2200,0,2200
2315,Stations of the Cross,FM,2015,1500,0,1500
2316,Skin Trade,Magn.,2015,1200,0,1200
2317,Thanks to My Friends,Distrib.,2015,900,0,900
2318,REC 4: Apocalypse,Magn.,2015,800,0,800
2319,It's All So Quiet (Boven is het stil),BWP,2015,700,0,700
2320,Tough Being Loved By Jerks,KL,2015,700,0,700
2321,The Chambermaid,FM,2015,300,0,300
2322,Captain America: Civil War,BV,2016,408100000,745200000,1153300000
2323,Rogue One: A Star Wars Story,BV,2016,532200000,523900000,1056100000
2324,Finding Dory,BV,2016,486300000,542300000,1028600000
2325,Zootopia,BV,2016,341300000,682500000,1023800000
2326,The Jungle Book (2016),BV,2016,364000000,602500000,966500000
2327,The Secret Life of Pets,Uni.,2016,368400000,507100000,875500000
2328,Batman v Superman: Dawn of Justice,WB,2016,330400000,543300000,873700000
2329,Fantastic Beasts and Where To Find Them,WB,2016,234000000,580000000,814000000
2330,Deadpool,Fox,2016,363100000,420000000,783100000
2331,Suicide Squad,WB,2016,325100000,421700000,746800000
2332,Doctor Strange,BV,2016,232600000,445100000,677700000
2333,Moana,BV,2016,248800000,394600000,643400000
2334,Sing,Uni.,2016,270400000,363800000,634200000
2335,The Mermaid (Mei ren yu),Sony,2016,3200000,550600000,553800000
2336,X-Men: Apocalypse,Fox,2016,155400000,388500000,543900000
2337,Kung Fu Panda 3,Fox,2016,143500000,377600000,521100000
2338,La La Land,LG/S,2016,151100000,295000000,446100000
2339,Warcraft,Uni.,2016,47400000,386300000,433700000
2340,Jason Bourne,Uni.,2016,162400000,253100000,415500000
2341,Ice Age: Collision Course,Fox,2016,64099999,344500000,408599999
2342,Independence Day: Resurgence,Fox,2016,103100000,286500000,389600000
2343,Monster Hunt,FR,2016,32800,385300000,385332800
2344,The Legend of Tarzan,WB,2016,126600000,230100000,356700000
2345,The Angry Birds Movie,Sony,2016,107500000,244800000,352300000
2346,Trolls,Fox,2016,153700000,193200000,346900000
2347,Star Trek Beyond,Par.,2016,158800000,184600000,343400000
2348,Now You See Me 2,LG/S,2016,65099999,269800000,334899999
2349,The Conjuring 2,WB (NL),2016,102500000,217900000,320400000
2350,Passengers (2016),Sony,2016,100000000,203100000,303100000
2351,Dangal,UTV,2016,12400000,290500000,302900000
2352,Alice Through the Looking Glass,BV,2016,77000000,222400000,299400000
2353,Miss Peregrine's Home for Peculiar Children,Fox,2016,87200000,209200000,296400000
2354,Teenage Mutant Ninja Turtles: Out of the Shadows,Par.,2016,82100000,163600000,245700000
2355,Assassin's Creed,Fox,2016,54600000,186300000,240900000
2356,Sully,WB,2016,125100000,115700000,240800000
2357,Hidden Figures,Fox,2016,169600000,66300000,235900000
2358,Ghostbusters (2016),Sony,2016,128400000,100800000,229200000
2359,Inferno,Sony,2016,34300000,185700000,220000000
2360,Central Intelligence,WB (NL),2016,127400000,89500000,216900000
2361,Bridget Jones's Baby,Uni.,2016,24300000,187700000,212000000
2362,Me Before You,WB (NL),2016,56200000,152100000,208300000
2363,London Has Fallen,Focus,2016,62500000,143200000,205700000
2364,Arrival,Par.,2016,100500000,102800000,203300000
2365,The Monkey King 2 in 3D,CL,2016,710000,193000000,193710000
2366,Bad Moms,STX,2016,113300000,70700000,184000000
2367,Storks,WB,2016,72700000,110700000,183400000
2368,The BFG,BV,2016,55500000,127900000,183400000
2369,The Divergent Series: Allegiant,LG/S,2016,66200000,113100000,179300000
2370,Hacksaw Ridge,LGF,2016,67200000,108100000,175300000
2371,The Girl on the Train (2016),Uni.,2016,75400000,97800000,173200000
2372,Operation Mekong,WGUSA,2016,800000,172300000,173100000
2373,The Huntsman: Winter's War,Uni.,2016,48400000,116600000,165000000
2374,The Magnificent Seven (2016),Sony,2016,93400000,68900000,162300000
2375,Jack Reacher: Never Go Back,Par.,2016,58700000,103400000,162100000
2376,Don't Breathe,SGem,2016,89200000,67900000,157100000
2377,Ip Man 3,WGUSA,2016,2700000,154200000,156900000
2378,The Accountant,WB,2016,86300000,68900000,155200000
2379,Gods of Egypt,LG/S,2016,31200000,119500000,150700000
2380,Lights Out,WB (NL),2016,67300000,81600000,148900000
2381,Pete's Dragon (2016),BV,2016,76200000,67500000,143700000
2382,Sausage Party,Sony,2016,97700000,43000000,140700000
2383,Lion,Wein.,2016,51700000,88600000,140300000
2384,Detective Chinatown (Tang ren jie tan an),CL,2016,474000,125400000,125874000
2385,Mechanic: Resurrection,LG/S,2016,21200000,104500000,125700000
2386,Ride Along 2,Uni.,2016,91200000,33400000,124600000
2387,Deepwater Horizon,LG/S,2016,61400000,60400000,121800000
2388,Allied,Par.,2016,40100000,79400000,119500000
2389,The Shallows,Sony,2016,55100000,64000000,119100000
2390,The Purge: Election Year,Uni.,2016,79200000,39400000,118600000
2391,Why Him?,Fox,2016,60300000,57800000,118100000
2393,Office Christmas Party,Par.,2016,54800000,59700000,114500000
2394,How to Be Single,WB (NL),2016,46800000,65500000,112300000
2395,10 Cloverfield Lane,Par.,2016,72100000,38100000,110200000
2396,The 5th Wave,Sony,2016,34900000,75000000,109900000
2397,Neighbors 2: Sorority Rising,Uni.,2016,55500000,52600000,108100000
2398,Cold War 2,WGUSA,2016,561000,102600000,103161000
2399,The Little Prince,EOne,2016,1300000,96200000,97500000
2400,Dirty Grandpa,LGF,2016,35600000,58500000,94100000
2401,Ben-Hur (2016),Par.,2016,26400000,67700000,94100000
2402,Money Monster,TriS,2016,41000000,52300000,93300000
2403,My Big Fat Greek Wedding 2,Uni.,2016,59700000,29200000,88900000
2404,Collateral Beauty,WB (NL),2016,31000000,57500000,88500000
2405,Train to Busan,WGUSA,2016,2100000,85400000,87500000
2406,Sultan,Yash,2016,6200000,81100000,87300000
2407,War Dogs,WB,2016,43000000,43200000,86200000
2408,Nerve,LGF,2016,38600000,46700000,85300000
2409,Ouija: Origin of Evil,Uni.,2016,35100000,46600000,81700000
2410,Manchester by the Sea,RAtt.,2016,47700000,31300000,79000000
2411,The Boss,Uni.,2016,63300000,15600000,78900000
2412,Shin Godzilla,FUN,2016,1900000,76000000,77900000
2413,Mike and Dave Need Wedding Dates,Fox,2016,46000000,31100000,77100000
2414,Boo! A Madea Halloween,LGF,2016,73200000,1600000,74800000
2415,Miracles from Heaven,TriS,2016,61700000,12200000,73900000
2416,I Am Not Madame Bovary,WGUSA,2016,437000,70400000,70837000
2417,Kubo and the Two Strings,Focus,2016,48000000,21900000,69900000
2418,13 Hours: The Secret Soldiers of Benghazi,Par.,2016,52900000,16600000,69500000
2419,Moonlight (2016),A24,2016,27900000,37200000,65100000
2420,Fences,Par.,2016,57700000,6700000,64400000
2421,The Boy (2016),STX,2016,35800000,28400000,64200000
2422,"Hail, Caesar!",Uni.,2016,30500000,33100000,63600000
2423,The Nice Guys,WB,2016,36300000,26500000,62800000
2424,L.O.R.D: Legend of Ravaging Dynasties,AR,2016,350000,57700000,58050000
2425,Nine Lives (2016),EC,2016,19700000,38100000,57800000
2426,Zoolander 2,Par.,2016,28800000,27900000,56700000
2427,Barbershop: The Next Cut,WB (NL),2016,54000000,1000000,55000000
2428,The Finest Hours,BV,2016,27600000,24500000,52100000
2429,Master,CJ,2016,597000,51000000,51597000
2430,Patriots Day,LGF,2016,31900000,18700000,50600000
2431,Florence Foster Jenkins,Par.,2016,27400000,21500000,48900000
2432,Mother's Day,ORF,2016,32500000,15900000,48400000
2433,Luck-Key,JBG,2016,467000,47700000,48167000
2434,Yo-kai Watch: The Movie,Elev.,2016,257000,47600000,47857000
2435,A Monster Calls,Focus,2016,3700000,43600000,47300000
2436,Eddie the Eagle,Fox,2016,15800000,30400000,46200000
2437,Risen,Sony,2016,36900000,9200000,46100000
2438,Blair Witch,LGF,2016,20800000,24400000,45200000
2439,Cafe Society,LGF,2016,11100000,32700000,43800000
2440,Almost Christmas,Uni.,2016,42200000,422000,42622000
2441,The Witch,A24,2016,25100000,15300000,40400000
2442,The Wild Life (2016),LG/S,2016,8000000,31500000,39500000
2443,Criminal (2016),LG/S,2016,14700000,24100000,38800000
2444,Absolutely Fabulous: The Movie,FoxS,2016,4800000,33100000,37900000
2445,Hell or High Water,LGF,2016,27000000,10900000,37900000
2446,The Forest,Focus,2016,26600000,11000000,37600000
2447,Snowden,ORF,2016,21600000,15700000,37300000
2448,Billy Lynn's Long Halftime Walk,TriS,2016,1700000,29200000,30900000
2449,When the Bough Breaks,SGem,2016,29700000,911000,30611000
2450,Nocturnal Animals,Focus,2016,10700000,19600000,30300000
2451,Keeping Up with the Joneses,Fox,2016,14900000,15000000,29900000
2452,Ae Dil Hai Mushkil,FIP,2016,4300000,24100000,28400000
2453,Fan,Yash,2016,2300000,25900000,28200000
2454,M.S. Dhoni: The Untold Story,FIP,2016,1800000,26000000,27800000
2455,The Light Between Oceans,BV,2016,12500000,13400000,25900000
2456,The Brothers Grimsby,Sony,2016,6900000,18300000,25200000
2457,Race (2016),Focus,2016,19200000,5900000,25100000
2458,Free State of Jones,STX,2016,20800000,4200000,25000000
2459,A Beautiful Planet,Imax,2016,15500000,9400000,24900000
2460,God's Not Dead 2,PFR,2016,20800000,3700000,24500000
2461,Silence (2016),Par.,2016,7100000,16600000,23700000
2462,Middle School: The Worst Years of My Life,LGF,2016,20000000,3300000,23300000
2463,Triple 9,ORF,2016,12600000,10500000,23100000
2464,Whiskey Tango Foxtrot,Par.,2016,23100000,0,23100000
2465,Captain Fantastic,BST,2016,5900000,16900000,22800000
2466,Live By Night,WB,2016,10400000,12300000,22700000
2467,Julieta,SPC,2016,1500000,21000000,22500000
2469,Fifty Shades of Black,ORF,2016,11700000,10500000,22200000
2470,Keanu,WB (NL),2016,20600000,0,20600000
2471,El Clan,FIP,2016,201000,20200000,20401000
2472,The Edge of Seventeen,STX,2016,14400000,4400000,18800000
2473,The Choice,LGF,2016,18700000,0,18700000
2474,Eye in the Sky,BST,2016,18700000,0,18700000
2475,Bad Santa 2,BG,2016,17800000,0,17800000
2476,Regression,W/Dim.,2016,55000,17600000,17655000
2477,Neerja,FIP,2016,1600000,16000000,17600000
2478,Masterminds (2016),Rela.,2016,17400000,0,17400000
2479,Norm of the North,LGF,2016,17100000,0,17100000
2480,Hardcore Henry,STX,2016,9300000,7600000,16900000
2481,Pride and Prejudice and Zombies,SGem,2016,10900000,5500000,16400000
2482,The Infiltrator,BG,2016,15400000,0,15400000
2483,Kapoor & Sons - Since 1921,FIP,2016,2600000,12800000,15400000
2484,The Take (2016),HTR,2016,50300,14800000,14850300
2485,Sword Master,WGUSA,2016,75500,14600000,14675500
2486,"Hello, My Name is Doris",RAtt.,2016,14400000,0,14400000
2487,The Other Side of the Door,Fox,2016,3000000,11300000,14300000
2488,Love & Friendship,RAtt.,2016,14000000,0,14000000
2489,Jackie,FoxS,2016,14000000,0,14000000
2490,Sing Street,Wein.,2016,3200000,10400000,13600000
2491,Shut In,EC,2016,6900000,6200000,13100000
2492,Loving,Focus,2016,7800000,5200000,13000000
2493,The Beatles: Eight Days a Week - The Touring Years,Abr.,2016,2900000,9400000,12300000
2494,The Man Who Knew Infinity,IFC,2016,3900000,8400000,12300000
2495,No Manches Frida,PNT,2016,11500000,0,11500000
2496,The Darkness,BH Tilt,2016,10800000,0,10800000
2497,Our Kind of Traitor,RAtt.,2016,3200000,7600000,10800000
2498,The Perfect Match,LGF,2016,9700000,745000,10445000
2499,Queen of Katwe,BV,2016,8900000,1500000,10400000
2500,Miss Sloane,EC,2016,3500000,5600000,9100000
2501,Ratchet & Clank,Focus,2016,8800000,0,8800000
2502,Morgan,Fox,2016,3900000,4900000,8800000
2503,The Lobster (US Release),A24,2016,8700000,0,8700000
2504,My King (Mon roi),FM,2016,54100,7900000,7954100
2505,Pele: Birth of a Legend,IFC,2016,57000,7800000,7857000
2506,A Bigger Splash,FoxS,2016,2000000,5500000,7500000
2507,Southside with You,RAtt.,2016,6300000,208000,6508000
2508,The Young Messiah,Focus,2016,6500000,0,6500000
2509,Incarnate,BH Tilt,2016,4800000,1500000,6300000
2510,Max Steel,ORF,2016,3800000,2500000,6300000
2511,Midnight Special,WB,2016,3700000,2500000,6200000
2512,The Duelist,Sony,2016,13500,6100000,6113500
2513,The Autopsy of Jane Doe,IFC,2016,10500,6000000,6010500
2514,My Best Friend's Wedding (2016),Sony,2016,78600,5600000,5678600
2515,Genius,RAtt.,2016,1400000,4300000,5700000
2516,20th Century Women,A24,2016,5700000,0,5700000
2517,Hunt for the Wilderpeople,Orch.,2016,5200000,0,5200000
2518,Bleed for This,ORF,2016,5100000,0,5100000
2519,Hands of Stone,Wein.,2016,4700000,0,4700000
2520,Men & Chicken,Drft.,2016,30200,4600000,4630200
2521,The Meddler,SPC,2016,4300000,0,4300000
2522,A Hologram for the King,RAtt.,2016,4200000,0,4200000
2523,Swiss Army Man,A24,2016,4200000,0,4200000
2524,Denial,BST,2016,4099999,0,4099999
2525,Indignation,RAtt.,2016,3400000,523000,3923000
2526,Kabali,CineGalaxy,2016,3900000,0,3900000
2527,Rules Don't Apply,Fox,2016,3700000,233000,3933000
2528,Where to Invade Next,Drft.,2016,3800000,0,3800000
2529,Batman: The Killing Joke,Fathom,2016,3800000,0,3800000
2530,Naam Hai Akira,FIP,2016,219000,3500000,3719000
2531,A Man Called Ove,MBox,2016,3500000,0,3500000
2532,Miles Ahead,SPC,2016,2600000,850000,3450000
2533,Everybody Wants Some!!,Par.,2016,3400000,0,3400000
2534,Maggie's Plan,SPC,2016,3400000,0,3400000
2535,The Program (2016),EOne,2016,13100,3300000,3313100
2536,Green Room,A24,2016,3200000,0,3200000
2537,The Eagle Huntress,SPC,2016,3200000,0,3200000
2538,Compadres,PNT,2016,3100000,0,3100000
2539,Desierto,STX,2016,2000000,1000000,3000000
2540,Anthropoid,BST,2016,3000000,0,3000000
2541,Hillsong - Let Hope Rise,PFR,2016,2400000,255000,2655000
2542,El Jeremias,Sony,2016,650000,1900000,2550000
2543,The Disappointments Room,Rela.,2016,2400000,0,2400000
2544,Dear Zindagi,Relbig.,2016,2400000,0,2400000
2545,Elle,SPC,2016,2300000,0,2300000
2546,Paterson,BST,2016,2200000,0,2200000
2547,Equals,A24,2016,33300,2100000,2133300
2548,I'm Not Ashamed,PFR,2016,2100000,0,2100000
2549,The Dressmaker,BG,2016,2000000,0,2000000
2550,The Handmaiden,Magn.,2016,2000000,0,2000000
2551,Demolition,FoxS,2016,2000000,0,2000000
2552,American Honey,A24,2016,663000,1200000,1863000
2553,Busco Novio Para Mi Mujer,PNT,2016,1700000,0,1700000
2554,A Perfect Day,IFC,2016,14000,1700000,1714000
2555,Weiner,IFC,2016,1700000,0,1700000
2556,Rustom,Zee,2016,1100000,571000,1671000
2557,I Saw the Light,SPC,2016,1600000,0,1600000
2558,Jane Got a Gun,Wein.,2016,1500000,0,1500000
2559,Toni Erdmann,SPC,2016,1500000,0,1500000
2560,The Neon Demon,BG,2016,1300000,0,1300000
2561,Embrace of the Serpent,Osci.,2016,1300000,0,1300000
2562,Housefull 3,Eros,2016,1300000,0,1300000
2563,Mohenjo Daro,UTV,2016,1300000,0,1300000
2564,Lazer Team,Ampl.,2016,1200000,0,1200000
2565,The Music of Strangers,Orch.,2016,1200000,0,1200000
2566,Dough,Men.,2016,1100000,0,1100000
2567,Ma ma,Osci.,2016,47300,1100000,1147300
2568,Wazir,Relbig.,2016,1100000,0,1100000
2569,Papa: Hemingway in Cuba,YFG,2016,1100000,0,1100000
2570,Certain Women,IFC,2016,1100000,0,1100000
2571,The Innocents,MBox,2016,1100000,0,1100000
2572,Elvis & Nixon,BST,2016,1100000,0,1100000
2573,Operation Chromite,CJ,2016,1000000,0,1000000
2574,Baar Baar Dekho,Eros,2016,982000,0,982000
2575,Dark Horse (2016),SPC,2016,941000,0,941000
2576,Neruda,Orch.,2016,939000,0,939000
2577,Gentleman,Gaatri,2016,898000,0,898000
2578,Ki & Ka,Eros,2016,858000,0,858000
2579,Dishoom,Eros,2016,813000,0,813000
2580,The Wailing (Goksung),WGUSA,2016,787000,0,787000
2581,Chongqing Hot Pot,CL,2016,780000,0,780000
2582,The Polar Express (2016 re-issue),WB,2016,765000,0,765000
2583,Little Men (2016),Magn.,2016,703000,0,703000
2584,Chaar Sahibzaade: Rise of Band Singh Bahadur,Eros,2016,701000,0,701000
2585,Born to be Blue (US Release),IFC,2016,678000,0,678000
2586,City of Gold,IFC,2016,641000,0,641000
2587,Remember (US Release),A24,2016,638000,0,638000
2588,Embrace: The Documentary,Gathr,2016,629000,0,629000
2589,Tickled,Magn.,2016,614000,0,614000
2590,"Lo and Behold, Reveries of the Connected World",Magn.,2016,595000,0,595000
2591,A Tale of Love and Darkness,FCW,2016,572000,0,572000
2592,Tunnel,WGUSA,2016,569000,0,569000
2593,Knight of Cups,BG,2016,566000,0,566000
2594,Harry & Snowman,FR,2016,561000,0,561000
2596,American Pastoral,LGF,2016,544000,0,544000
2597,The Age of Shadows,CJ,2016,542000,0,542000
2598,Fitoor,UTV,2016,529000,0,529000
2599,The First Monday in May,Magn.,2016,527000,0,527000
2600,Marguerite,Cohen,2016,497000,0,497000
2601,The Boy and the Beast,FUN,2016,491000,0,491000
2602,Wiener-Dog,IFC,2016,477000,0,477000
2603,Our Little Sister,SPC,2016,468000,0,468000
2604,Only Yesterday (2016 re-release),GK,2016,453000,0,453000
2605,Baaghi,UTV,2016,438000,0,438000
2606,Land of Mine,SPC,2016,435000,0,435000
2607,Things To Come,IFC,2016,388000,0,388000
2608,The Lobster (Canada Release),Mon,2016,377000,0,377000
2609,Mr. Donkey,CL,2016,356000,0,356000
2610,Happy Bhaag Jayegi,Eros,2016,352000,0,352000
2611,High-Rise,Magn.,2016,346000,0,346000
2612,Te3n,Rel.,2016,332000,0,332000
2613,Francofonia,MBox,2016,307000,0,307000
2614,Mia Madre,MBox,2016,303000,0,303000
2615,April and the Extraordinary World,GK,2016,295000,0,295000
2616,Ixcanul,KL,2016,295000,0,295000
2617,The People vs. Fritz Bauer,Cohen,2016,288000,0,288000
2618,Aquarius,Vita.,2016,286000,0,286000
2619,Kingsglaive: Final Fantasy: XV,VE,2016,270000,0,270000
2620,My Golden Days,Magn.,2016,269000,0,269000
2621,The Family Fang,SM,2016,263000,0,263000
2622,Dheepan,IFC,2016,262000,0,262000
2623,"Life, Animated",Orch.,2016,255000,0,255000
2624,Oasis: Supersonic,A24,2016,243000,0,243000
2625,The Invitation,Drft.,2016,232000,0,232000
2626,Miss Hokusai,GK,2016,223000,0,223000
2627,Kaptaan,UTV,2016,204000,0,204000
2628,League of Gods,Sony,2016,182000,0,182000
2629,Viva,Magn.,2016,178000,0,178000
2630,The Wave,Magn.,2016,177000,0,177000
2631,Asura: The City of Madness,CJ,2016,176000,0,176000
2632,Louder than Bombs,Orch.,2016,164000,0,164000
2633,Howards End (2016 Restoration),Cohen,2016,160000,0,160000
2634,Sunset Song,Magn.,2016,160000,0,160000
2635,Born to be Blue,EOne,2016,152000,0,152000
2636,Seasons,MBox,2016,150000,0,150000
2637,Rams (Hr√∫tar),Cohen,2016,149000,0,149000
2638,Tumbledown,SM,2016,135000,0,135000
2639,The Brand New Testament,MBox,2016,128000,0,128000
2640,Spirits' Homecoming,PM&E,2016,126000,0,126000
2641,Sweet Bean,KL,2016,125000,0,125000
2642,A War,Magn.,2016,123000,0,123000
2643,Fire at Sea,KL,2016,121000,0,121000
2644,Hockney,FM,2016,121000,0,121000
2645,Three,WGUSA,2016,120000,0,120000
2646,Tale of Tales,IFC,2016,119000,0,119000
2647,The Measure of a Man,KL,2016,112000,0,112000
2648,Aferim!,BWP,2016,108000,0,108000
2649,Until Forever (Por Siempre),CZ,2016,105000,0,105000
2650,Under the Sun (2016),Icar.,2016,105000,0,105000
2651,Our Last Tango,Strand,2016,100000,0,100000
2652,Rock On 2,Eros,2016,98900,0,98900
2653,Seondal: The Man Who Sells the River,CJ,2016,97500,0,97500
2654,So Young 2: Never Gone,CL,2016,96400,0,96400
2655,"New York, New York (2016)",CL,2016,92400,0,92400
2656,Fireworks Wednesday,Ghop,2016,90500,0,90500
2657,No One's Life Is Easy: So I Married an Anti-Fan,CL,2016,89300,0,89300
2658,"My Love, Don't Cross that River",FM,2016,88000,0,88000
2659,Author: The JT LeRoy Story,Magn.,2016,86000,0,86000
2660,Mountains May Depart,KL,2016,82900,0,82900
2661,Cock and Bull,CL,2016,82800,0,82800
2662,A Street Cat Named Bob,Cleopatra,2016,82700,0,82700
2663,Les cowboys,Cohen,2016,80800,0,80800
2664,Saala Khadoos,UTV,2016,76900,0,76900
2665,The Monster (2016),A24,2016,12500,62200,74700
2666,Dancer,IFC,2016,71900,0,71900
2667,Sweet 20,CJ,2016,71800,0,71800
2668,The Dark Horse,BG,2016,67500,0,67500
2669,Phantom Detective,CJ,2016,67100,0,67100
2670,Ran (2016 re-issue),Rialto,2016,66100,0,66100
2671,Microbe & Gasoline,Scre.,2016,63800,0,63800
2672,Time Renegades,CJ,2016,59400,0,59400
2673,Vanishing Time: A Boy Who Returned,Dreamwest,2016,57800,0,57800
2674,DONGJU: The Portrait of a Poet,CJ,2016,56600,0,56600
2675,L'attesa,Osci.,2016,55800,0,55800
2676,The Lovers and the Despot,Magn.,2016,55500,0,55500
2677,Clown,W/Dim.,2016,55000,0,55000
2678,Diary of a Chambermaid,Cohen,2016,54200,0,54200
2679,High Strung (2016),Pala.,2016,53400,0,53400
2680,The Club,MBox,2016,52800,0,52800
2681,Being 17,Strand,2016,52700,0,52700
2682,The Last Man on the Moon,Grav.,2016,52500,0,52500
2683,My Annoying Brother,CJ,2016,52000,0,52000
2684,Cemetery of Splendor,Strand,2016,52000,0,52000
2685,Disorder,IFC,2016,51900,0,51900
2686,Like for Likes,CJ,2016,50800,0,50800
2687,In the Shadow of Women,Distrib.,2016,50300,0,50300
2688,In Order of Disappearance,Magn.,2016,50300,0,50300
2689,The Treasure,SDS,2016,50200,0,50200
2690,Fatima,KL,2016,50100,0,50100
2691,We Are X,Drft.,2016,45300,0,45300
2692,A Melody to Remember,CJ,2016,44300,0,44300
2693,Phantom of the Theatre,WGUSA,2016,44000,0,44000
2694,Mastizaade,Eros,2016,43400,0,43400
2695,Closet Monster,Strand,2016,42200,0,42200
2696,Troublemakers: The Story of Land Art,FRun,2016,29500,9100,38600
2697,Come What May,Cohen,2016,37800,0,37800
2698,Until Forever,Linn,2016,35800,0,35800
2699,Summertime (2016),Strand,2016,35300,0,35300
2700,Songs My Brothers Taught Me,KL,2016,34800,0,34800
2701,Mr. Right,FCW,2016,34700,0,34700
2702,Phantom Boy,GK,2016,34400,0,34400
2703,Sweet Sixteen (Xia You Qiao Mu),CL,2016,34300,0,34300
2704,Eisenstein in Guanajuato,Strand,2016,34300,0,34300
2705,Last Cab to Darwin,FRun,2016,34200,0,34200
2706,The Map Against the World,CJ,2016,34000,0,34000
2707,Kaili Blues,Ghop,2016,32200,0,32200
2708,Anesthesia,IFC,2016,32200,0,32200
2709,"Rio, I Love You",Scre.,2016,32000,0,32000
2710,As I Open My Eyes,KL,2016,31000,0,31000
2711,The Son of Joseph,KL,2016,30600,0,30600
2712,From Afar,Strand,2016,30200,0,30200
2713,For a Few Bullets,CL,2016,30100,0,30100
2714,The Last Princess,CJ,2016,29300,0,29300
2715,Valley of Love,Strand,2016,28600,0,28600
2716,Blackway,Electric,2016,27100,0,27100
2717,Neon Bull,KL,2016,26700,0,26700
2718,Papa (Luo shan ji dao dan ji hua),Jampa,2016,26700,0,26700
2719,Standing Tall (La tete haute),Cohen,2016,26100,0,26100
2720,Chevalier,Strand,2016,25700,0,25700
2721,The New Year's Eve of Old Lee,CL,2016,25400,0,25400
2722,Cosmos,KL,2016,25300,0,25300
2723,A Monster with a Thousand Heads,MBox,2016,24900,0,24900
2724,Evolution,IFC,2016,24800,0,24800
2725,"Right Now, Wrong Then",Ghop,2016,24500,0,24500
2726,Lolo,FR,2016,24100,0,24100
2727,Sanam Teri Kasam,Eros,2016,22100,0,22100
2728,Term Life,FCW,2016,21300,0,21300
2729,The Sea of Trees,A24,2016,20400,0,20400
2730,Wildflower (Secretos del Alma),CZ,2016,18100,0,18100
2731,Colonia,Scre.,2016,15700,0,15700
2732,Argentina,FRun,2016,14900,0,14900
2733,Remember You,CJ,2016,14800,0,14800
2734,Adderall Diaries,A24,2016,13200,0,13200
2735,Neither Heaven Nor Earth,FM,2016,12800,0,12800
2736,The Ones Below,Magn.,2016,12500,0,12500
2737,"Kiki, Love to Love",Strand,2016,12500,0,12500
2738,Don't Call Me Son,Zeit.,2016,11700,0,11700
2739,Jeruzalem,EpicPics,2016,11300,0,11300
2740,Serial Killer 1,KL,2016,10300,0,10300
2741,Chronic,MR,2016,9000,0,9000
2742,Magnus,FR,2016,8900,0,8900
2743,The Last King,Magn.,2016,8900,0,8900
2744,Mojave,A24,2016,8300,0,8300
2745,The Other Side,FM,2016,8100,0,8100
2746,The President,Crnth,2016,7600,0,7600
2747,They Will Have to Kill Us First,BBC,2016,7500,0,7500
2748,The Carer,Crnth,2016,6200,0,6200
2749,Klown Forever,Drft.,2016,5700,0,5700
2750,Search Party,FCW,2016,4600,0,4600
2751,In Harmony,Distrib.,2016,3100,0,3100
2752,In Her Name (Au nom de ma fille),Distrib.,2016,1600,0,1600
2753,Next Time I'll Aim for the Heart,Distrib.,2016,800,0,800
2754,The Student and Mr. Henri,Distrib.,2016,800,0,800
2755,Down By Love,Distrib.,2016,700,0,700
2756,News From Planet Mars,KL,2016,300,0,300
2757,Satanic,Magn.,2016,300,0,300
2758,Star Wars: The Last Jedi,BV,2017,620200000,712400000,1332600000
2759,Beauty and the Beast (2017),BV,2017,504000000,759500000,1263500000
2760,The Fate of the Furious,Uni.,2017,226000000,1010,226001010
2761,Despicable Me 3,Uni.,2017,264600000,770200000,1034800000
2762,Jumanji: Welcome to the Jungle,Sony,2017,404500000,557600000,962100000
2763,Spider-Man: Homecoming,Sony,2017,334200000,546000000,880200000
2764,Wolf Warrior 2,HC,2017,2700000,867600000,870300000
2765,Guardians of the Galaxy Vol. 2,BV,2017,389800000,473900000,863700000
2766,Thor: Ragnarok,BV,2017,315100000,538900000,854000000
2767,Wonder Woman,WB,2017,412600000,409300000,821900000
2768,Coco,BV,2017,209700000,597400000,807100000
2769,Pirates of the Caribbean: Dead Men Tell No Tales,BV,2017,172600000,622300000,794900000
2770,It,WB (NL),2017,327500000,372900000,700400000
2771,Justice League,WB,2017,229000000,428900000,657900000
2772,Logan (2017),Fox,2017,226300000,392700000,619000000
2773,Transformers: The Last Knight,Par.,2017,130199999,475300000,605499999
2774,Kong: Skull Island,WB,2017,168100000,398600000,566700000
2775,The Boss Baby,Fox,2017,175000000,353000000,528000000
2776,Dunkirk,WB,2017,188000000,337200000,525200000
2777,War for the Planet of the Apes,Fox,2017,146900000,343800000,490700000
2778,The Greatest Showman,Fox,2017,174300000,260700000,435000000
2779,Kingsman: The Golden Circle,Fox,2017,100200000,310700000,410900000
2780,The Mummy (2017),Uni.,2017,80200000,329000000,409200000
2781,Cars 3,BV,2017,152900000,231000000,383900000
2782,Fifty Shades Darker,Uni.,2017,114600000,267000000,381600000
2783,Your Name.,FUN,2017,5000000,353000000,358000000
2784,Murder on the Orient Express (2017),Fox,2017,102800000,250000000,352800000
2785,xXx: The Return of Xander Cage,Par.,2017,44900000,301200000,346100000
2786,The Great Wall,Uni.,2017,45500000,289400000,334900000
2787,Resident Evil: The Final Chapter,SGem,2017,26800000,285400000,312200000
2788,The LEGO Batman Movie,WB,2017,175800000,136200000,312000000
2789,Annabelle: Creation,WB (NL),2017,102100000,204400000,306500000
2790,Wonder,LGF,2017,132400000,173500000,305900000
2791,Ferdinand,Fox,2017,84400000,211700000,296100000
2792,Split,Uni.,2017,138300000,140200000,278500000
2793,Blade Runner 2049,WB,2017,92100000,167200000,259300000
2794,Get Out,Uni.,2017,176000000,79400000,255400000
2795,Kung Fu Yoga,WGUSA,2017,363000,253800000,254163000
2796,Baahubali 2: The Conclusion,GrtIndia,2017,20200000,234000000,254200000
2797,Journey to the West: The Demons Strike Back,Sony,2017,880000,245700000,246580000
2798,Alien: Covenant,Fox,2017,74300000,166600000,240900000
2799,Baby Driver,TriS,2017,107800000,119100000,226900000
2800,Valerian and the City of a Thousand Planets,STX,2017,41200000,184700000,225900000
2801,Geostorm,WB,2017,33700000,187900000,221600000
2802,The Emoji Movie,Sony,2017,86100000,131699999,217799999
2803,A Dog's Purpose,Uni.,2017,64500000,140500000,205000000
2804,Smurfs: The Lost Village,Sony,2017,45000000,152200000,197200000
2805,The Shape of Water,FoxS,2017,63900000,131400000,195300000
2806,Pitch Perfect 3,Uni.,2017,104900000,80500000,185400000
2807,Daddy's Home 2,Par.,2017,104000000,76600000,180600000
2808,The Post,Fox,2017,81900000,97900000,179800000
2809,Baywatch,Par.,2017,58100000,119800000,177900000
2810,The Hitman's Bodyguard,LG/S,2017,75500000,101100000,176600000
2811,John Wick: Chapter Two,LG/S,2017,92000000,79500000,171500000
2812,Ghost in the Shell (2017),Par.,2017,40600000,129199999,169799999
2813,"Three Billboards Outside Ebbing, Missouri",FoxS,2017,54500000,104700000,159200000
2814,Duckweed,CL,2017,472000,150600000,151072000
2815,Darkest Hour,Focus,2017,56500000,94400000,150900000
2816,King Arthur: Legend of the Sword,WB,2017,39200000,109500000,148700000
2817,The Foreigner,STX,2017,34400000,111000000,145400000
2818,Power Rangers (2017),LGF,2017,85400000,57000000,142400000
2819,Girls Trip,Uni.,2017,115200000,25400000,140600000
2820,American Made,Uni.,2017,51300000,83500000,134800000
2821,A Bad Moms Christmas,STX,2017,72100000,58400000,130500000
2822,Captain Underpants: The First Epic Movie,Fox,2017,73900000,51600000,125500000
2823,Happy Death Day,Uni.,2017,55700000,69800000,125500000
2824,The LEGO Ninjago Movie,WB,2017,59300000,63800000,123100000
2826,The Dark Tower,Sony,2017,50700000,62500000,113200000
2827,Buddies in India,CL,2017,293000,109300000,109593000
2828,Leap!,Wein.,2017,21900000,81400000,103300000
2829,Jigsaw,LGF,2017,38100000,64900000,103000000
2830,Railroad Tigers,WGUSA,2017,218000,102000000,102218000
2831,Life (2017),Sony,2017,30200000,70300000,100500000
2832,Atomic Blonde,Focus,2017,51700000,48300000,100000000
2833,The Shack,LG/S,2017,57400000,39600000,97000000
2834,Some Like It Hot (Qing Shung),CL,2017,100000,95600000,95700000
2835,Tiger Zinda Hai,Yash,2017,5600000,81800000,87400000
2836,Going in Style (2017),WB (NL),2017,45000000,39900000,84900000
2837,Rings,Par.,2017,27800000,55300000,83100000
2838,A Taxi Driver,WGUSA,2017,1500000,80100000,81600000
2839,Underworld: Blood Wars,SGem,2017,30400000,50700000,81100000
2840,Lady Bird,A24,2017,49000000,30000000,79000000
2841,American Assassin,LGF,2017,36200000,31000000,67200000
2842,One Piece Film: Gold,FUN,2017,424000,65800000,66224000
2843,Victoria and Abdul,Focus,2017,22200000,43200000,65400000
2844,The Nut Job 2: Nutty by Nature,ORF,2017,28400000,36800000,65200000
2845,Monster Trucks,Par.,2017,33400000,31100000,64500000
2846,The Mountain Between Us,Fox,2017,30300000,32500000,62800000
2847,The Star,Sony,2017,40900000,22000000,62900000
2848,How to be a Latin Lover,PNT,2017,32100000,29700000,61800000
2849,"Everything, Everything",WB,2017,34100000,27500000,61600000
2850,Snatched,Fox,2017,45900000,15000000,60900000
2851,My Little Pony: The Movie,LGF,2017,21900000,38400000,60300000
2852,Molly's Game,STX,2017,28800000,30500000,59300000
2853,All the Money in the World,TriS,2017,25100000,31900000,57000000
2854,The Big Sick,LGF,2017,42900000,13500000,56400000
2855,Confidential Assignment,CJ,2017,476000,55500000,55976000
2856,Downsizing,Par.,2017,24400000,30600000,55000000
2857,"I, Tonya",Neon,2017,30000000,23900000,53900000
2858,Logan Lucky,BST,2017,27800000,20700000,48500000
2859,Tyler Perry's Boo 2! A Madea Halloween,LGF,2017,47300000,1000000,48300000
2860,Phantom Thread,Focus,2017,21200000,26600000,47800000
2861,Rough Night,Sony,2017,22100000,25200000,47300000
2862,The Battleship Island,CJ,2017,1100000,45000000,46100000
2863,Flatliners (2017),Sony,2017,16900000,28300000,45200000
2864,All Eyez on Me,LG/S,2017,44900000,0,44900000
2865,mother!,Par.,2017,17800000,26700000,44500000
2866,47 Meters Down,ENTMP,2017,44300000,0,44300000
2867,The Snowman,Uni.,2017,6700000,36400000,43100000
2868,Gifted,FoxS,2017,24800000,18200000,43000000
2869,Loving Vincent,Good Deed,2017,6700000,35500000,42200000
2870,Call Me by Your Name,SPC,2017,18100000,23800000,41900000
2871,T2: Trainspotting,TriS,2017,2400000,39300000,41700000
2872,Fist Fight,WB (NL),2017,32200000,8900000,41100000
2873,Diary of a Wimpy Kid: The Long Haul,Fox,2017,20700000,19400000,40100000
2874,The House,WB (NL),2017,25600000,8600000,34200000
2875,Tad the Lost Explorer and the Secret of King Midas,ParC,2017,5900,34200000,34205900
2876,Wind River,Wein.,2017,33800000,0,33800000
2877,Sleepless,ORF,2017,20800000,12100000,32900000
2878,Kidnap (2017),Aviron,2017,31000000,0,31000000
2879,The Disaster Artist,A24,2017,21100000,8700000,29800000
2880,Hostiles,ENTMP,2017,29800000,0,29800000
2881,The Beguiled (2017),Focus,2017,10700000,16700000,27400000
2882,Home Again,ORF,2017,27000000,0,27000000
2883,Judwaa 2,FIP,2017,1400000,25500000,26900000
2884,CHiPs,WB,2017,18600000,8199999,26799999
2885,The Bye Bye Man,STX,2017,22400000,4300000,26700000
2886,A Cure for Wellness,Fox,2017,8100000,18500000,26600000
2887,The Zookeeper's Wife,Focus,2017,17600000,8600000,26200000
2888,Only The Brave,Sony,2017,18300000,7400000,25700000
2889,Father Figures,WB,2017,17500000,8100000,25600000
2890,Badrinath Ki Dulhania,FIP,2017,2000000,23200000,25200000
2891,Born in China,BV,2017,13900000,11200000,25100000
2892,The Founder,Wein.,2017,12800000,11300000,24100000
2893,Jolly Llb 2,FIP,2017,1700000,21300000,23000000
2894,The Glass Castle,LGF,2017,17300000,4600000,21900000
2895,Sword Art Online: The Movie - Ordinal Scale,Elev.,2017,1500000,19200000,20700000
2896,The Circle (2017),STX,2017,20500000,0,20500000
2897,It Comes At Night,A24,2017,14000000,5300000,19300000
2898,The Lost City of Z,BST,2017,8600000,10700000,19300000
2899,Unforgettable (2017),WB,2017,11400000,6400000,17800000
2900,The Case for Christ,PFR,2017,14700000,3000000,17700000
2901,Detroit,Annapurna,2017,16800000,0,16800000
2902,Wonder Wheel,Amazon,2017,1400000,14500000,15900000
2903,Gold,Wein.,2017,7200000,7700000,14900000
2904,The Space Between Us,STX,2017,7900000,6900000,14800000
2905,Wish Upon,BG,2017,14300000,0,14300000
2906,A United Kingdom,FoxS,2017,3900000,9900000,13800000
2907,"Roman J. Israel, Esq.",Sony,2017,12000000,1100000,13100000
2908,Mubarakan,Sony,2017,759000,12100000,12859000
2909,Battle of the Sexes,FoxS,2017,12600000,0,12600000
2910,The Promise (2017),ORF,2017,8199999,4200000,12399999
2911,Before I Fall,ORF,2017,12200000,0,12200000
2912,Earth: One Amazing Day,BBC,2017,81300,11600000,11681300
2913,Thank You for Your Service (2017),Uni.,2017,9500000,0,9500000
2914,Rock Dog,LG/S,2017,9400000,0,9400000
2915,My Cousin Rachel,FoxS,2017,2700000,6500000,9200000
2916,Truman,FR,2017,211000,8800000,9011000
2917,Stronger,RAtt.,2017,4200000,4200000,8400000
2918,Tulip Fever,Wein.,2017,2500000,5900000,8400000
2919,Viceroy's House,IFC,2017,1100000,6700000,7800000
2920,Amityville: The Awakening,W/Dim.,2017,700,7700000,7700700
2921,Just Getting Started,BG,2017,6100000,1600000,7700000
2922,Beatriz At Dinner,RAtt.,2017,7100000,310000,7410000
2923,I am Not Your Negro,Magn.,2017,7100000,0,7100000
2924,The Red Turtle,SPC,2017,922000,5700000,6622000
2925,From the Land of the Moon,IFC,2017,47700,6500000,6547700
2926,Maudie,SPC,2017,6200000,0,6200000
2927,All Saints,Affirm,2017,5800000,140000,5940000
2928,The Florida Project,A24,2017,5900000,0,5900000
2929,Suburbicon,Par.,2017,5800000,0,5800000
2930,The Man Who Invented Christmas,BST,2017,5700000,0,5700000
2931,Paris Can Wait,SPC,2017,5600000,0,5600000
2932,Phillauri,FIP,2017,468000,5000000,5468000
2933,Ok Jaanu,FIP,2017,356000,5000000,5356000
2934,An Inconvenient Sequel: Truth to Power,Par.,2017,3500000,1900000,5400000
2935,Table 19,FoxS,2017,3600000,1400000,5000000
2936,Collide,ORF,2017,2300000,2500000,4800000
2937,The Wall,RAtt.,2017,1800000,2700000,4500000
2938,Mark Felt: The Man Who Brought Down the White House,SPC,2017,769000,3600000,4369000
2939,Terminator 2: Judgment Day 3D,Distrib.,2017,1000000,2900000,3900000
2940,Brad's Status,Annapurna,2017,2100000,1700000,3800000
2941,Friend Request,ENTMP,2017,3800000,0,3800000
2942,Their Finest,STX,2017,3600000,0,3600000
2943,Wonderstruck,RAtt.,2017,1100000,2200000,3300000
2944,The Leisure Seeker,SPC,2017,3200000,0,3200000
2945,Raw (2017),FCW,2017,515000,2600000,3115000
2946,Colossal,Neon,2017,3000000,0,3000000
2947,A Gentleman,FIP,2017,410000,2500000,2910000
2948,Inhumans,Imax,2017,1500000,1300000,2800000
2949,Kedi,Osci.,2017,2800000,0,2800000
2950,The Only Living Boy in New York,RAtt.,2017,624000,1900000,2524000
2951,Hazlo Como Hombre (Do It Like An Hombre),PNT,2017,2500000,0,2500000
2952,Poster Boys,Sony,2017,97000,2400000,2497000
2953,The Salesman,Cohen,2017,2400000,0,2400000
2954,Pokemon the Movie: I Choose You!,Fathom,2017,2400000,0,2400000
2955,Jeepers Creepers 3,Scre.,2017,2300000,0,2300000
2956,Un Padre No Tan Padre,PNT,2017,2200000,0,2200000
2957,Good Time,A24,2017,2000000,0,2000000
2958,Everybody Loves Somebody,PNT,2017,1900000,0,1900000
2959,Along with the Gods: The Two Worlds,WGUSA,2017,1900000,0,1900000
2960,Youth (2017),CL,2017,1900000,0,1900000
2961,Last Flag Flying,LGF,2017,965000,904000,1869000
2962,A Quiet Passion,MBox,2017,1900000,0,1900000
2963,Free Fire,A24,2017,1800000,0,1800000
2964,The Last Word,BST,2017,1800000,0,1800000
2965,Human Flow,Magn.,2017,528000,1300000,1828000
2966,Jane (2017),Abr.,2017,1700000,0,1700000
2967,A Ghost Story,A24,2017,1600000,0,1600000
2968,The Square,Magn.,2017,1500000,0,1500000
2969,Patti Cake$,FoxS,2017,800000,682000,1482000
2970,The Wedding Plan,RAtt.,2017,1400000,0,1400000
2971,Personal Shopper,IFC,2017,1300000,0,1300000
2972,Churchill,Cohen,2017,1300000,0,1300000
2973,The Sense of an Ending,CBS,2017,1300000,0,1300000
2974,3 Idiotas,PNT,2017,1200000,0,1200000
2975,6 Below: Miracle on the Mountain,MOM,2017,14800,1100000,1114800
2976,Lady Macbeth,RAtt.,2017,1100000,0,1100000
2977,Film Stars Don't Die in Liverpool,SPC,2017,1000000,0,1000000
2978,Yu-Gi-Oh! The Dark Side of Dimensions,SV,2017,1000000,0,1000000
2979,Lucky (2017),Magn.,2017,956000,0,956000
2980,Faces Places,Cohen,2017,954000,0,954000
2981,Tubelight,Yash,2017,930000,0,930000
2982,Frantz,MBox,2017,881000,0,881000
2983,BOMBSHELL: The Hedy Lamarr Story,Zeit.,2017,820000,0,820000
2984,Walk With Me,Gathr,2017,727000,0,727000
2985,Buena Vista Social Club: Adios,BG,2017,123000,578000,701000
2986,Titanic (20th Anniversary),Par.,2017,692000,0,692000
2987,Lost in Paris,Osci.,2017,692000,0,692000
2988,Shubh Mangal Saavdhan,Eros,2017,690000,0,690000
2989,The Midwife,MBox,2017,604000,0,604000
2990,3 Generations,Wein.,2017,156000,375000,531000
2991,Fairy Tail: Dragon Cry,FUN,2017,519000,0,519000
2992,Our President,CJ,2017,507000,0,507000
2993,Letters from Baghdad,Vita.,2017,360000,143000,503000
2994,Breathe (2017),BST,2017,490000,0,490000
2995,Song to Song,BG,2017,444000,0,444000
2996,Tom of Finland,KL,2017,378000,0,378000
2997,God's Own Country,Orion,2017,336000,0,336000
2998,The Breadwinner,GK,2017,312000,0,312000
2999,A Silent Voice,Elev.,2017,310000,0,310000
3000,My Life as a Zucchini,GK,2017,310000,0,310000
3001,Happy End,SPC,2017,302000,0,302000
3002,After the Storm,FM,2017,272000,0,272000
3003,Wakefield,IFC,2017,263000,0,263000
3004,"I, Daniel Blake",IFC,2017,260000,0,260000
3005,Cezanne et moi,Magn.,2017,258000,0,258000
3006,The Fortress,CJ,2017,253000,0,253000
3007,Black Butler: Book of the Atlantic,FUN,2017,248000,0,248000
3008,The Swindlers,WGUSA,2017,242000,0,242000
3009,City of Ghosts,IFC,2017,128000,100000,228000
3010,The Prison,WGUSA,2017,207000,0,207000
3011,The Other Side of Hope,Jan.,2017,184000,0,184000
3012,Marjorie Prime,FR,2017,181000,0,181000
3013,Graduation,IFC,2017,176000,0,176000
3014,Mr. Gaga: A True Story of Love and Dance,Abr.,2017,174000,0,174000
3015,In This Corner of the World,FUN,2017,172000,0,172000
3016,David Lynch: The Art Life,Jan.,2017,171000,0,171000
3017,13 Minutes,SPC,2017,162000,0,162000
3018,The Journey,IFC,2017,155000,0,155000
3019,The Void,Scre.,2017,151000,0,151000
3020,Blade of the Immortal,Magn.,2017,151000,0,151000
3021,Thelma,Orch.,2017,147000,0,147000
3022,BPM (Beats Per Minute),Orch.,2017,125000,0,125000
3023,Explosion,CL,2017,123000,0,123000
3024,The King's Choice,Gold.,2017,113000,0,113000
3025,Slack Bay,KL,2017,113000,0,113000
3026,Like Crazy (2017),Strand,2017,107000,0,107000
3027,Fabricated City,CJ,2017,105000,0,105000
3028,The Lure,Jan.,2017,102000,0,102000
3029,Score: A Film Music Documentary,Grav.,2017,101000,0,101000
3030,Munna Michael,Eros,2017,99600,0,99600
3031,The Mayor,WGUSA,2017,96800,0,96800
3032,The Fencer,CFI,2017,96000,0,96000
3033,Memoir of a Murderer,WGUSA,2017,91300,0,91300
3034,The King's Case Note,CJ,2017,91000,0,91000
3035,Warriors of the Dawn,FIP,2017,84500,0,84500
3036,The Nile Hilton Incident,Strand,2017,81100,0,81100
3037,Pop Aye,KL,2017,78000,0,78000
3038,I Can Speak,CJ,2017,63200,0,63200
3039,Tomorrow,UTMW,2017,62500,0,62500
3040,Worlds Apart,CLS,2017,60300,0,60300
3041,Extraordinary Mission,Crimson,2017,54200,0,54200
3042,The Ornithologist,Strand,2017,50500,0,50500
3043,Napping Princess,GK,2017,48200,0,48200
3044,Twenty Two,CL,2017,46800,0,46800
3045,Bluebeard,WGUSA,2017,43100,0,43100
3046,One Week and a Day,Osci.,2017,41600,0,41600
3047,The Commune,Magn.,2017,38700,0,38700
3048,A Woman's Life,KL,2017,37600,0,37600
3049,Afterimage,FM,2017,33400,0,33400
3050,Alone in Berlin,IFC,2017,33100,0,33100
3051,The Villainess,WGUSA,2017,27700,0,27700
3052,The Daughter,KL,2017,26400,0,26400
3053,Moscow Never Sleeps,CAVU,2017,25300,0,25300
3054,My Scientology Movie,Magn.,2017,22900,0,22900
3055,Una,EF,2017,22800,0,22800
3056,Bending the Arc,Abr.,2017,21900,0,21900
3057,The Girl Without Hands,GK,2017,21800,0,21800
3058,Whisky Galore,Arrow,2017,21000,0,21000
3059,RV: Resurrected Victims,WGUSA,2017,20400,0,20400
3060,Better Watch Out,WGUSA,2017,20400,0,20400
3061,Absolutely Anything,ADC,2017,20200,0,20200
3062,Glory (2017),FM,2017,18400,0,18400
3063,Porto,KL,2017,15100,0,15100
3064,Brotherhood of Blades 2: The Infernal Battlefield,WGUSA,2017,14200,0,14200
3065,Abracadabra,Sony,2017,14000,0,14000
3066,Blind,VE,2017,12500,0,12500
3067,Felicite,Strand,2017,12400,0,12400
3068,Dead Awake (2017),FR,2017,11500,0,11500
3069,The Country Doctor,Distrib.,2017,8500,0,8500
3070,Overdrive,VE,2017,7800,0,7800
3071,Suntan,Strand,2017,6600,0,6600
3072,Trespass Against Us,A24,2017,5700,0,5700
3073,The Ardennes,FM,2017,5600,0,5600
3074,Oro,Sony,2017,5500,0,5500
3075,Singularity,VE,2017,4200,0,4200
3076,Emily (2017),Hiber,2017,3600,0,3600
3077,Max & Leon,Distrib.,2017,500,0,500
3078,2:22,Magn.,2017,400,0,400
3079,Avengers: Infinity War,BV,2018,678800000,1369,678801369
3080,Black Panther,BV,2018,700100000,646900000,1347000000
3081,Jurassic World: Fallen Kingdom,Uni.,2018,417700000,891800000,1309500000
3082,Incredibles 2,BV,2018,608600000,634200000,1242800000
3083,Aquaman,WB,2018,335100000,812700000,1147800000
3084,Bohemian Rhapsody,Fox,2018,216400000,687200000,903600000
3085,Venom (2018),Sony,2018,213500000,641500000,855000000
3086,Mission: Impossible - Fallout,Par.,2018,220200000,571000000,791200000
3087,Deadpool 2,Fox,2018,318500000,460500000,779000000
3088,Fantastic Beasts: The Crimes of Grindelwald,WB,2018,159600000,494100000,653700000
3089,Ant-Man and the Wasp,BV,2018,216600000,406000000,622600000
3090,Ready Player One,WB,2018,137700000,445200000,582900000
3091,Operation Red Sea,WGUSA,2018,1500000,577700000,579200000
3092,Detective Chinatown 2,WB,2018,2000000,542100000,544100000
3093,The Meg,WB,2018,145400000,384800000,530200000
3094,Ralph Breaks the Internet,BV,2018,201100000,328100000,529200000
3095,Hotel Transylvania 3: Summer Vacation,Sony,2018,167500000,361100000,528600000
3096,Dr. Seuss' The Grinch (2018),Uni.,2018,270600000,241000000,511600000
3097,Bumblebee,Par.,2018,127200000,340800000,468000000
3098,A Star is Born (2018),WB,2018,215300000,218900000,434200000
3099,Rampage (2018),WB (NL),2018,101000000,327000000,428000000
3100,Mamma Mia! Here We Go Again,Uni.,2018,120600000,274400000,395000000
3101,Solo: A Star Wars Story,BV,2018,213800000,179200000,393000000
3102,Spider-Man: Into The Spider-Verse,Sony,2018,190200000,185300000,375500000
3103,Fifty Shades Freed,Uni.,2018,100400000,271500000,371900000
3104,The Nun,WB (NL),2018,117500000,248100000,365600000
3105,Monster Hunt 2,LGF,2018,706000,361000000,361706000
3106,Peter Rabbit,Sony,2018,115300000,236000000,351300000
3107,Mary Poppins Returns,BV,2018,172000000,177600000,349600000
3108,A Quiet Place,Par.,2018,188000000,152900000,340900000
3109,Green Book,Uni.,2018,85100000,234700000,319800000
3110,Skyscraper,Uni.,2018,68400000,236400000,304800000
3111,Ocean's 8,WB,2018,140200000,157500000,297700000
3112,Pacific Rim Uprising,Uni.,2018,59900000,231100000,291000000
3113,Maze Runner: The Death Cure,Fox,2018,58000000,230200000,288200000
3114,Tomb Raider,WB,2018,58300000,216400000,274700000
3115,Halloween (2018),Uni.,2018,159300000,96100000,255400000
3116,Crazy Rich Asians,WB,2018,174500000,64000000,238500000
3117,Paddington 2,WB,2018,40900000,186400000,227300000
3118,Smallfoot,WB,2018,83200000,130900000,214100000
3119,Creed II,MGM,2018,115700000,98300000,214000000
3120,Disney's Christopher Robin,BV,2018,99200000,98500000,197700000
3121,The Equalizer 2,Sony,2018,102100000,88300000,190400000
3122,The Nutcracker and the Four Realms,BV,2018,54900000,119100000,174000000
3123,The Mule,WB,2018,103800000,68700000,172500000
3124,Insidious: The Last Key,Uni.,2018,67700000,100100000,167800000
3125,The Predator (2018),Fox,2018,51000000,109500000,160500000
3126,Johnny English Strikes Again,Uni.,2018,4400000,154500000,158900000
3127,Red Sparrow,Fox,2018,46900000,104700000,151600000
3128,The First Purge,Uni.,2018,69500000,67500000,137000000
3129,A Wrinkle in Time,BV,2018,100500000,32200000,132700000
3130,The House With A Clock In Its Walls,Uni.,2018,68500000,62900000,131400000
3131,Instant Family,Par.,2018,67400000,53200000,120600000
3132,The Commuter,LGF,2018,36300000,83600000,119900000
3133,Game Night,WB (NL),2018,69200000,48500000,117700000
3134,The Monkey King 3,WGUSA,2018,187000,114900000,115087000
3135,First Man,Uni.,2018,44900000,60800000,105700000
3136,Night School (2018),Uni.,2018,77300000,25800000,103100000
3137,Alpha,Studio 8,2018,35900000,62300000,98200000
3138,A Simple Favor,LGF,2018,53500000,44100000,97600000
3139,The Favourite,FoxS,2018,34400000,61600000,96000000
3140,Truth or Dare,Uni.,2018,41400000,53900000,95300000
3141,I Feel Pretty,STX,2018,48800000,45700000,94500000
3142,Blockers,Uni.,2018,60300000,33700000,94000000
3143,Goosebumps 2: Haunted Halloween,Sony,2018,46700000,46600000,93300000
3144,BlacKkKlansman,Focus,2018,49300000,44000000,93300000
3145,Overboard (2018),PNT,2018,50300000,40900000,91200000
3146,Sherlock Gnomes,Par.,2018,43200000,47100000,90300000
3147,Robin Hood (2018),LG/S,2018,30800000,54000000,84800000
3148,Mortal Engines,Uni.,2018,16000000,67700000,83700000
3149,How Long Will I Love U,WGUSA,2018,747000,82100000,82847000
3150,Den of Thieves,STX,2018,44900000,35600000,80500000
3151,Hereditary,A24,2018,44100000,35300000,79400000
3152,Tag,WB (NL),2018,54700000,23400000,78100000
3153,Vice,Annapurna,2018,47800000,28200000,76000000
3154,Widows,Fox,2018,42400000,33600000,76000000
3155,Sicario: Day of the Soldado,Sony,2018,50100000,25800000,75900000
3156,Searching,SGem,2018,26000000,49400000,75400000
3157,The Spy Who Dumped Me,LGF,2018,33600000,41800000,75400000
3158,Second Act,STX,2018,39300000,33000000,72300000
3159,Sanju,FIP,2018,7900000,63600000,71500000
3160,Book Club,Par.,2018,68600000,0,68600000
3161,12 Strong,WB,2018,45800000,21600000,67400000
3162,"Love, Simon",Fox,2018,40800000,25500000,66300000
3163,Mile 22,STX,2018,36100000,30200000,66300000
3164,Life of the Party,WB (NL),2018,53100000,12800000,65900000
3165,Isle Of Dogs,FoxS,2018,32000000,32200000,64200000
3166,Adrift,STX,2018,31400000,28500000,59900000
3167,The 15:17 to Paris,WB,2018,36300000,20800000,57100000
3168,Early Man,LGF,2018,8300000,46400000,54700000
3169,Peppermint,STX,2018,35400000,18400000,53800000
3170,Teen Titans Go! To The Movies,WB,2018,29800000,22300000,52100000
3171,Slender Man,SGem,2018,30600000,21200000,51800000
3172,Breaking In (2018),Uni.,2018,46800000,4600000,51400000
3173,Once Upon a Deadpool,Fox,2018,6100000,44400000,50500000
3174,The Son of Bigfoot,VPD,2018,289000,46800000,47089000
3175,Uncle Drew,LG/S,2018,42500000,4200000,46700000
3176,Tyler Perry's Acrimony,LGF,2018,43500000,2900000,46400000
3177,Mary Queen of Scots,Focus,2018,16500000,29900000,46400000
3178,The Possession of Hannah Grace,SGem,2018,14800000,28200000,43000000
3179,Overlord,Par.,2018,21700000,20000000,41700000
3180,The Darkest Minds,Fox,2018,12700000,28400000,41100000
3181,Holmes and Watson,Sony,2018,30600000,9900000,40500000
3182,Show Dogs,Global Road,2018,17900000,21300000,39200000
3183,On the Basis of Sex,Focus,2018,24600000,13600000,38200000
3184,Namiya,CL,2018,70800,35300000,35370800
3185,The Girl in the Spider's Web: A New Dragon Tattoo Story,Sony,2018,14800000,20300000,35100000
3186,The Hate U Give,Fox,2018,29700000,5200000,34900000
3187,Death Wish (2018),MGM,2018,34000000,0,34000000
3188,Nobody's Fool,Par.,2018,31700000,1800000,33500000
3189,Bad Times At The El Royale,Fox,2018,17800000,14000000,31800000
3190,Baaghi 2,FIP,2018,1300000,29900000,31200000
3191,The Happytime Murders,STX,2018,20700000,6800000,27500000
3192,Midnight Sun,Global Road,2018,9600000,17800000,27400000
3193,Pad Man,Sony,2018,1700000,25600000,27300000
3194,Monster Family,VPD,2018,127000,26300000,26427000
3195,White Boy Rick,Studio 8,2018,24000000,1900000,25900000
3196,Winchester,LGF,2018,25100000,0,25100000
3197,The Death of Stalin,IFC,2018,8000000,16600000,24600000
3198,Strangers: Prey at Night,Aviron,2018,24600000,0,24600000
3199,"Paul, Apostle of Christ",Affirm,2018,17600000,5500000,23100000
3200,Padmaavat,VPD,2018,11800000,11100000,22900000
3201,Proud Mary,SGem,2018,20900000,876000,21776000
3202,Superfly,Sony,2018,20500000,236000,20736000
3203,If Beale Street Could Talk,Annapurna,2018,14900000,5700000,20600000
3204,Burn the Stage: The Movie,Trafalgar,2018,4200000,16100000,20300000
3205,Detective K: Secret of the Living Dead,WGUSA,2018,104000,18500000,18604000
3206,The Wife,SPC,2018,9600000,8600000,18200000
3207,Hell Fest,LGF,2018,11100000,7100000,18200000
3208,Chappaquiddick,ENTMP,2018,17400000,591000,17991000
3209,They Shall Not Grow Old,WB,2018,18000000,0,18000000
3210,Free Solo,NGE,2018,17500000,0,17500000
3211,The Children Act,A24,2018,548000,17000000,17548000
3212,Beautiful Boy (2018),Amazon,2018,7600000,8700000,16300000
3213,Hunter Killer,LG/S,2018,15800000,0,15800000
3214,Tully (2018),Focus,2018,9400000,6300000,15700000
3215,Unfriended: Dark Web,BH Tilt,2018,8900000,6300000,15200000
3216,Upgrade,BH Tilt,2018,12000000,2400000,14400000
3217,Unsane,BST,2018,7700000,6600000,14300000
3218,The Sisters Brothers,Annapurna,2018,3100000,10000000,13100000
3219,Welcome to Marwen,Uni.,2018,10800000,2100000,12900000
3220,Hotel Artemis,Global Road,2018,6700000,6000000,12700000
3221,Marrowbone,Magn.,2018,1400,12300000,12301400
3222,102 Not Out,Sony,2018,1300000,10900000,12200000
3223,Boy Erased,Focus,2018,6800000,5000000,11800000
3224,Back to Burgundy,MBox,2018,258000,11400000,11658000
3225,The Bookshop,Greenwich,2018,1600000,9900000,11500000
3226,The Old Man & the Gun,FoxS,2018,11300000,0,11300000
3227,Gringo,STX,2018,5000000,6000000,11000000
3228,Golden Slumber,CJ,2018,94500,10600000,10694500
3229,Kin,LGF,2018,5700000,4300000,10000000
3230,The Big Bad Fox and Other Tales,GK,2018,35800,9600000,9635800
3231,Traffik,LGF,2018,9200000,336000,9536000
3232,Can You Ever Forgive Me?,FoxS,2018,8800000,0,8800000
3233,7 Days in Entebbe,Focus,2018,3300000,5400000,8700000
3234,Pope Francis - A Man of His Word,Focus,2018,2000000,6600000,8600000
3235,Condorito: La Pelicula,LGF,2018,448000,8000000,8448000
3236,Suspiria,Amazon,2018,2500000,5400000,7900000
3237,Disobedience,BST,2018,3500000,4400000,7900000
3238,Qu√© Le√≥n (What A Lion),Spanglish,2018,2600000,5200000,7800000
3239,Life Itself (2018),Amazon,2018,4099999,3700000,7799999
3240,Beirut,BST,2018,5000000,2500000,7500000
3241,Return of the Hero,Distrib.,2018,37100,7300000,7337100
3242,Soorma,Sony,2018,390000,6200000,6590000
3243,The Hurricane Heist,ENTMP,2018,6100000,0,6100000
3244,Every Day (2018),Orion,2018,6100000,0,6100000
3245,Leave No Trace,BST,2018,6000000,0,6000000
3246,My Hero Academia: Two Heroes,FUN,2018,5800000,0,5800000
3247,Destroyer,Annapurna,2018,1500000,4000000,5500000
3248,Madame,Blue Fox,2018,91000,5300000,5391000
3249,Colette,BST,2018,5100000,0,5100000
3250,Blindspotting,LG/S,2018,4300000,530000,4830000
3251,Cold War (2018),Amazon,2018,4600000,0,4600000
3252,Papillon (2018),BST,2018,2300000,2200000,4500000
3253,Gotti,VE,2018,4300000,0,4300000
3254,The Mercy,Scre.,2018,29500,4200000,4229500
3255,Hichki,Yash,2018,330000,3900000,4230000
3256,Ya Veremos,PNT,2018,4200000,0,4200000
3257,Don't Worry He Won't Get Far on Foot,Amazon,2018,1400000,2500000,3900000
3258,A Private War,Aviron,2018,1600000,2200000,3800000
3259,Ben is Back,RAtt.,2018,3700000,0,3700000
3260,Bad Samaritan,Electric,2018,3400000,0,3400000
3261,Gauguin: Voyage to Tahiti,Cohen,2018,200000,3100000,3300000
3262,Shoplifters,Magn.,2018,3300000,0,3300000
3263,The Front Runner,Sony,2018,2000000,1200000,3200000
3264,2001: A Space Odyssey (2018 re-release),WB,2018,3200000,0,3200000
3265,Wildlife,IFC,2018,1100000,2000000,3100000
3266,La Boda de Valentina,PNT,2018,2800000,0,2800000
3267,You Were Never Really Here,Amazon,2018,2500000,0,2500000
3268,Billionaire Boy's Club,VE,2018,1300,2500000,2501300
3269,The Rider,SPC,2018,2400000,0,2400000
3270,Mary and the Witch's Flower,GK,2018,2400000,0,2400000
3271,Bilal: A New Breed of Hero,VE,2018,491000,1700000,2191000
3272,A Fantastic Woman,SPC,2018,2000000,0,2000000
3273,MET Opera: La Traviata,Fathom,2018,1900000,0,1900000
3274,Capernaum,SPC,2018,1700000,0,1700000
3275,I Still See You,LGF,2018,1400,1500000,1501400
3276,Finding Your Feet,RAtt.,2018,1400000,0,1400000
3277,Never Look Away,SPC,2018,1300000,0,1300000
3278,Maria by Callas,SPC,2018,1300000,0,1300000
3279,Mandy,RLJ,2018,1200000,0,1200000
3280,Andhadhun,Eros,2018,1200000,0,1200000
3281,Lean on Pete,A24,2018,1200000,0,1200000
3282,Nothing to Lose (2018),Swen,2018,1000000,0,1000000
3283,Raid (2018),Eros,2018,1000000,0,1000000
3284,The Insult,Cohen,2018,1000000,0,1000000
3285,Little Italy,EOne,2018,990000,0,990000
3286,The Catcher Was a Spy,IFC,2018,725000,229000,954000
3287,The Miseducation of Cameron Post,FR,2018,905000,0,905000
3288,Kedarnath,PackYourBag,2018,901000,0,901000
3289,Schindler's List (2018 re-release),Uni.,2018,833000,0,833000
3290,Mirai,GK,2018,813000,0,813000
3291,Beast,RAtt.,2018,800000,0,800000
3292,Pokemon the Movie: The Power of Us,Fathom,2018,789000,0,789000
3293,The Party (2017),RAtt.,2018,750000,0,750000
3294,Burning,WGUSA,2018,719000,0,719000
3295,Foxtrot,SPC,2018,619000,0,619000
3296,The Sound of Music (2018 re-release),Fathom,2018,616000,0,616000
3297,The Big Lebowski (20th Anniversary),Fathom,2018,583000,0,583000
3298,Manmarziyaan,Eros,2018,567000,0,567000
3299,Loveless (2018),SPC,2018,566000,0,566000
3300,Tommy Wiseau's The Room,Fathom,2018,550000,0,550000
3301,Fireworks (2018),GK,2018,525000,0,525000
3302,The Spy Gone North,CJ,2018,501000,0,501000
3303,The Happy Prince,SPC,2018,466000,0,466000
3304,Final Portrait,SPC,2018,462000,0,462000
3305,Bag of Marbles,Gaum.,2018,411000,0,411000
3306,Vertigo (60th Anniversary),Fathom,2018,394000,0,394000
3307,Oh Lucy!,FM,2018,375000,0,375000
3308,Mountain,Greenwich,2018,365000,0,365000
3309,Time Freak,Grindstone,2018,10000,256000,266000
3310,What They Had,BST,2018,260000,0,260000
3311,Batti Gul Meter Chalu,Eros,2018,250000,0,250000
3312,Borg vs. McEnroe,Neon,2018,231000,0,231000
3313,Matangi/Maya/M.I.A.,Abr.,2018,231000,0,231000
3314,Mazinger Z: INFINITY,Fathom,2018,221000,0,221000
3315,Fate/Stay Night: Heaven's Feel - I. Presage Flower,Fathom,2018,194000,0,194000
3316,Summer 1993,Osci.,2018,186000,0,186000
3317,Maquia: When the Promised Flower Blooms (Subtitled),Elev.,2018,186000,0,186000
3318,Karwaan,PackYourBag,2018,182000,0,182000
3319,Last Letter,CL,2018,181000,0,181000
3320,The Accidental Detective 2: In Action,CJ,2018,179000,0,179000
3321,The Guardians,MBox,2018,177000,0,177000
3322,Luis & the Aliens,VPD,2018,170000,0,170000
3323,Double Lover,Cohen,2018,168000,0,168000
3324,Ghost Stories,IFC,2018,149000,0,149000
3325,Museo,Vita.,2018,149000,0,149000
3326,The Little Mermaid (2018),Conglomerate,2018,147000,0,147000
3327,The Young Karl Marx,Orch.,2018,126000,0,126000
3328,Becoming Astrid,MBox,2018,120000,0,120000
3329,Ryuichi Sakamoto: Coda,MUBI,2018,117000,0,117000
3330,Gonjiam: Haunted Asylum,WGUSA,2018,115000,0,115000
3331,Take Point,CJ,2018,112000,0,112000
3332,The Dawn Wall,Orch.,2018,112000,0,112000
3333,The Negotiation,CJ,2018,111000,0,111000
3334,The Captain,MBox,2018,109000,0,109000
3335,Mary Shelley,IFC,2018,109000,0,109000
3336,In Between,FM,2018,108000,0,108000
3337,Namaste England,Eros,2018,104000,0,104000
3338,Happy Phirr Bhag Jayegi,Eros,2018,103000,0,103000
3339,Ismael's Ghosts,Magn.,2018,103000,0,103000
3340,Revenge (2018),Neon,2018,102000,0,102000
3341,Unstoppable (2018),WGUSA,2018,101000,0,101000
3342,Reign of Judges: Title of Liberty - Concept Short,Darin Southa,2018,93200,5200,98400
3343,The Third Murder,FM,2018,89300,0,89300
3344,The House That Jack Built,IFC,2018,88000,0,88000
3345,Custody,KL,2018,83900,0,83900
3346,Godard Mon Amour,Cohen,2018,82300,0,82300
3347,Just a Breath Away,EOne,2018,78000,0,78000
3348,Mukkabaaz,Eros,2018,75900,0,75900
3349,Keys to the Heart,CJ,2018,75100,0,75100
3350,Tehran Taboo,KL,2018,74800,0,74800
3351,The Last Suit,OutF,2018,73500,0,73500
3352,"Nico, 1988",Magn.,2018,73300,0,73300
3353,Antonio Lopez 1970: Sex Fashion & Disco,FM,2018,43200,30000,73200
3354,Helicopter Eela,Eros,2018,72000,0,72000
3355,Under the Tree,Magn.,2018,67600,0,67600
3356,Before We Vanish,Super,2018,52100,0,52100
3357,I Am Not a Witch,FM,2018,50900,0,50900
3358,Racer & the Jailbird,Super,2018,46300,0,46300
3359,Rodin,Cohen,2018,44300,0,44300
3360,What Will People Say,KL,2018,44200,0,44200
3361,A Ciambra,IFC,2018,41900,0,41900
3362,Oolong Courtyard,CL,2018,37700,0,37700
3363,Girls vs Gangsters,WGUSA,2018,37100,0,37100
3364,"No Date, No Signature",Distrib.,2018,36400,0,36400
3365,The Apparition (2018),MBox,2018,28300,0,28300
3366,The Charmer,FM,2018,26200,0,26200
3367,Elliot: The Littlest Reindeer,Scre.,2018,24300,0,24300
3368,The Workshop,Strand,2018,22100,0,22100
3369,Loving Pablo,Uni.,2018,22000,0,22000
3370,A Paris Education,KL,2018,21600,0,21600
3371,Tag Along: The Devil Fish,CL,2018,20700,0,20700
3372,Gabriel and the Mountain,Strand,2018,18400,0,18400
3373,Marlina the Murderer in Four Acts,Icar.,2018,17800,0,17800
3374,The Escape,IFC,2018,14000,0,14000
3375,How Victor 'The Garlic' Took Alexey 'The Stud' to the Nursing Home,CARUSEL,2018,13000,0,13000
3376,"Lou Andreas-Salom√©, the Audacity to be Free",CLS,2018,12900,0,12900
3377,Let Yourself Go,Men.,2018,12200,0,12200
3378,Hannah (2018),PDF,2018,11700,0,11700
3379,Souvenir,Strand,2018,11400,0,11400
3380,Furious (Legend of Kolovrat),CARUSEL,2018,10000,0,10000
3381,Beauty and the Dogs,Osci.,2018,8900,0,8900
3382,The Quake,Magn.,2018,6200,0,6200
3383,Edward II (2018 re-release),FM,2018,4800,0,4800
3384,El Pacto,Sony,2018,2500,0,2500
3385,The Swan,Synergetic,2018,2400,0,2400
3386,An Actor Prepares,Grav.,2018,1700,0,1700
